COUNTY_ID,TOWN_ID,V_ID,H_CNT,P_CNT,M_CNT,F_CNT,INFO_TIME
10002,10002100,10002100-005,198,490,250,240,107Y09M
10002,10002100,10002100-017,671,1765,965,800,107Y09M
10002,10002100,10002100-015,609,1369,724,645,107Y09M
10002,10002100,10002100-010,1901,4821,2484,2337,107Y09M
10002,10002100,10002100-002,243,587,328,259,107Y09M
10002,10002100,10002100-003,286,846,463,383,107Y09M
10002,10002100,10002100-008,389,1013,554,459,107Y09M
10002,10002100,10002100-011,411,1001,533,468,107Y09M
10002,10002100,10002100-018,601,1611,881,730,107Y09M
10002,10002100,10002100-016,381,852,473,379,107Y09M
10002,10002100,10002100-009,661,1410,788,622,107Y09M
10002,10002100,10002100-001,100,222,128,94,107Y09M
10002,10002100,10002100-013,227,563,291,272,107Y09M
10002,10002100,10002100-007,501,1292,647,645,107Y09M
10002,10002100,10002100-014,358,813,453,360,107Y09M
10002,10002100,10002100-012,280,693,388,305,107Y09M
10002,10002100,10002100-006,574,1410,783,627,107Y09M
10002,10002100,10002100-004,257,644,361,283,107Y09M
10002,10002110,10002110-007,27,58,38,20,107Y09M
10002,10002110,10002110-008,298,1025,528,497,107Y09M
10002,10002110,10002110-003,257,843,464,379,107Y09M
10002,10002110,10002110-009,265,915,476,439,107Y09M
10002,10002110,10002110-010,69,254,137,117,107Y09M
10002,10002110,10002110-005,148,416,225,191,107Y09M
10002,10002110,10002110-002,228,797,428,369,107Y09M
10002,10002110,10002110-001,360,1133,598,535,107Y09M
10002,10002110,10002110-004,109,300,171,129,107Y09M
10002,10002110,10002110-006,159,497,268,229,107Y09M
10002,10002090,10002090-002,770,1988,966,1022,107Y09M
10002,10002090,10002090-001,855,2287,1205,1082,107Y09M
10002,10002090,10002090-004,750,1725,882,843,107Y09M
10002,10002090,10002090-009,1514,4183,2149,2034,107Y09M
10002,10002090,10002090-005,596,1438,726,712,107Y09M
10002,10002090,10002090-008,1588,4168,2166,2002,107Y09M
10002,10002090,10002090-006,1205,2739,1393,1346,107Y09M
10002,10002090,10002090-014,1335,3631,1875,1756,107Y09M
10002,10002090,10002090-013,815,2249,1148,1101,107Y09M
10002,10002090,10002090-011,653,1760,938,822,107Y09M
10002,10002090,10002090-010,1440,3739,1899,1840,107Y09M
10002,10002090,10002090-015,1136,3222,1684,1538,107Y09M
10002,10002090,10002090-007,786,1989,1050,939,107Y09M
10002,10002090,10002090-012,599,1613,861,752,107Y09M
10002,10002090,10002090-003,1037,2842,1495,1347,107Y09M
10002,10002080,10002080-012,339,1018,542,476,107Y09M
10002,10002080,10002080-004,338,1028,540,488,107Y09M
10002,10002080,10002080-013,567,1645,870,775,107Y09M
10002,10002080,10002080-024,338,906,515,391,107Y09M
10002,10002080,10002080-005,355,1027,557,470,107Y09M
10002,10002080,10002080-014,207,554,293,261,107Y09M
10002,10002080,10002080-011,614,1725,905,820,107Y09M
10002,10002080,10002080-009,318,808,420,388,107Y09M
10002,10002080,10002080-016,1330,3372,1694,1678,107Y09M
10002,10002080,10002080-010,285,874,443,431,107Y09M
10002,10002080,10002080-006,545,1668,855,813,107Y09M
10002,10002080,10002080-001,542,1338,710,628,107Y09M
10002,10002080,10002080-008,1338,3853,1936,1917,107Y09M
10002,10002080,10002080-023,788,1961,1010,951,107Y09M
10002,10002080,10002080-002,684,1933,965,968,107Y09M
10002,10002080,10002080-007,1245,3861,1911,1950,107Y09M
10002,10002080,10002080-020,485,1227,651,576,107Y09M
10002,10002080,10002080-018,1634,4472,2204,2268,107Y09M
10002,10002080,10002080-019,975,2711,1465,1246,107Y09M
10002,10002080,10002080-015,2123,5629,2899,2730,107Y09M
10002,10002080,10002080-017,2087,5237,2676,2561,107Y09M
10002,10002080,10002080-003,481,1372,714,658,107Y09M
10002,10002080,10002080-022,723,1888,960,928,107Y09M
10002,10002080,10002080-021,1062,2752,1387,1365,107Y09M
10002,10002060,10002060-013,716,1986,1028,958,107Y09M
10002,10002060,10002060-010,517,1407,735,672,107Y09M
10002,10002060,10002060-009,658,1796,963,833,107Y09M
10002,10002060,10002060-014,449,1197,624,573,107Y09M
10002,10002060,10002060-007,308,879,456,423,107Y09M
10002,10002060,10002060-001,1075,2908,1489,1419,107Y09M
10002,10002060,10002060-008,956,2699,1433,1266,107Y09M
10002,10002060,10002060-004,384,1095,581,514,107Y09M
10002,10002060,10002060-011,981,2513,1356,1157,107Y09M
10002,10002060,10002060-002,772,2067,1099,968,107Y09M
10002,10002060,10002060-005,633,1819,967,852,107Y09M
10002,10002060,10002060-012,447,1164,632,532,107Y09M
10002,10002060,10002060-003,417,1075,584,491,107Y09M
10002,10002060,10002060-006,609,1717,901,816,107Y09M
10002,10002010,10002010-016,542,1757,919,838,107Y09M
10002,10002010,10002010-043,1189,3148,1471,1677,107Y09M
10002,10002010,10002010-045,380,867,425,442,107Y09M
10002,10002010,10002010-021,738,1830,901,929,107Y09M
10002,10002010,10002010-031,480,1065,528,537,107Y09M
10002,10002010,10002010-046,1297,3525,1668,1857,107Y09M
10002,10002010,10002010-039,1460,3831,1830,2001,107Y09M
10002,10002010,10002010-028,494,1333,696,637,107Y09M
10002,10002010,10002010-026,944,2631,1284,1347,107Y09M
10002,10002010,10002010-036,1080,2810,1339,1471,107Y09M
10002,10002010,10002010-002,1007,2055,1038,1017,107Y09M
10002,10002010,10002010-041,1395,3880,1872,2008,107Y09M
10002,10002010,10002010-032,757,1981,1027,954,107Y09M
10002,10002010,10002010-023,525,1325,694,631,107Y09M
10002,10002010,10002010-015,1438,4162,2011,2151,107Y09M
10002,10002010,10002010-014,957,2770,1383,1387,107Y09M
10002,10002010,10002010-019,491,1111,584,527,107Y09M
10002,10002010,10002010-034,646,1681,824,857,107Y09M
10002,10002010,10002010-011,1093,2569,1245,1324,107Y09M
10002,10002010,10002010-009,514,1497,791,706,107Y09M
10002,10002010,10002010-037,739,1949,920,1029,107Y09M
10002,10002010,10002010-010,786,2140,1080,1060,107Y09M
10002,10002010,10002010-038,1996,5254,2492,2762,107Y09M
10002,10002010,10002010-035,1419,3741,1747,1994,107Y09M
10002,10002010,10002010-044,928,2557,1169,1388,107Y09M
10002,10002010,10002010-001,1260,3036,1475,1561,107Y09M
10002,10002010,10002010-025,876,2424,1194,1230,107Y09M
10002,10002010,10002010-027,1254,3665,1874,1791,107Y09M
10002,10002010,10002010-012,514,1537,811,726,107Y09M
10002,10002010,10002010-040,1346,3101,1467,1634,107Y09M
10002,10002010,10002010-022,651,1497,724,773,107Y09M
10002,10002010,10002010-008,1031,2448,1187,1261,107Y09M
10002,10002010,10002010-017,820,2093,987,1106,107Y09M
10002,10002010,10002010-018,791,1790,900,890,107Y09M
10002,10002010,10002010-024,1096,3041,1526,1515,107Y09M
10002,10002010,10002010-042,1410,3931,1840,2091,107Y09M
10002,10002010,10002010-013,760,2274,1129,1145,107Y09M
10002,10002010,10002010-047,1454,3464,1610,1854,107Y09M
10002,10002120,10002120-003,177,573,273,300,107Y09M
10002,10002120,10002120-005,198,543,299,244,107Y09M
10002,10002120,10002120-004,182,572,281,291,107Y09M
10002,10002120,10002120-006,225,623,328,295,107Y09M
10002,10002120,10002120-001,498,1494,774,720,107Y09M
10002,10002120,10002120-002,392,1260,645,615,107Y09M
10002,10002120,10002120-007,300,961,508,453,107Y09M
10002,10002070,10002070-004,590,1719,915,804,107Y09M
10002,10002070,10002070-008,301,706,415,291,107Y09M
10002,10002070,10002070-007,668,1745,890,855,107Y09M
10002,10002070,10002070-009,724,2098,1097,1001,107Y09M
10002,10002070,10002070-012,941,2802,1520,1282,107Y09M
10002,10002070,10002070-002,915,2440,1301,1139,107Y09M
10002,10002070,10002070-011,923,2643,1456,1187,107Y09M
10002,10002070,10002070-001,2437,6506,3267,3239,107Y09M
10002,10002070,10002070-005,853,2116,1117,999,107Y09M
10002,10002070,10002070-003,648,1884,992,892,107Y09M
10002,10002070,10002070-015,402,1143,621,522,107Y09M
10002,10002070,10002070-016,595,1583,890,693,107Y09M
10002,10002070,10002070-013,366,1010,520,490,107Y09M
10002,10002070,10002070-014,376,985,563,422,107Y09M
10002,10002070,10002070-006,492,1353,738,615,107Y09M
10002,10002070,10002070-010,510,1549,820,729,107Y09M
10002,10002040,10002040-023,483,1310,685,625,107Y09M
10002,10002040,10002040-021,391,1074,579,495,107Y09M
10002,10002040,10002040-009,519,1572,778,794,107Y09M
10002,10002040,10002040-002,273,781,391,390,107Y09M
10002,10002040,10002040-003,363,1008,516,492,107Y09M
10002,10002040,10002040-022,383,1203,628,575,107Y09M
10002,10002040,10002040-006,351,1006,540,466,107Y09M
10002,10002040,10002040-001,128,313,167,146,107Y09M
10002,10002040,10002040-004,154,376,207,169,107Y09M
10002,10002040,10002040-014,821,2507,1284,1223,107Y09M
10002,10002040,10002040-005,529,1516,757,759,107Y09M
10002,10002040,10002040-016,880,2441,1228,1213,107Y09M
10002,10002040,10002040-008,645,1872,920,952,107Y09M
10002,10002040,10002040-019,277,803,445,358,107Y09M
10002,10002040,10002040-018,708,1970,1058,912,107Y09M
10002,10002040,10002040-011,214,587,309,278,107Y09M
10002,10002040,10002040-012,222,644,332,312,107Y09M
10002,10002040,10002040-010,323,812,407,405,107Y09M
10002,10002040,10002040-013,274,744,368,376,107Y09M
10002,10002040,10002040-020,550,1576,820,756,107Y09M
10002,10002040,10002040-007,310,790,402,388,107Y09M
10002,10002040,10002040-015,868,2402,1241,1161,107Y09M
10002,10002040,10002040-017,379,1099,595,504,107Y09M
10002,10002040,10002040-024,234,794,388,406,107Y09M
10002,10002050,10002050-018,201,475,263,212,107Y09M
10002,10002050,10002050-007,543,1396,759,637,107Y09M
10002,10002050,10002050-010,964,2761,1472,1289,107Y09M
10002,10002050,10002050-004,1372,2994,1463,1531,107Y09M
10002,10002050,10002050-005,274,750,394,356,107Y09M
10002,10002050,10002050-006,626,1665,859,806,107Y09M
10002,10002050,10002050-009,992,2448,1305,1143,107Y09M
10002,10002050,10002050-002,1001,2248,1157,1091,107Y09M
10002,10002050,10002050-013,462,1197,648,549,107Y09M
10002,10002050,10002050-001,692,1878,1003,875,107Y09M
10002,10002050,10002050-012,377,971,538,433,107Y09M
10002,10002050,10002050-014,595,1501,819,682,107Y09M
10002,10002050,10002050-015,1077,2895,1505,1390,107Y09M
10002,10002050,10002050-011,476,1359,726,633,107Y09M
10002,10002050,10002050-008,643,1642,876,766,107Y09M
10002,10002050,10002050-017,394,1084,591,493,107Y09M
10002,10002050,10002050-003,2154,4561,2217,2344,107Y09M
10002,10002050,10002050-016,1331,3819,1940,1879,107Y09M
10002,10002020,10002020-004,779,1812,870,942,107Y09M
10002,10002020,10002020-029,687,1632,788,844,107Y09M
10002,10002020,10002020-030,498,1198,574,624,107Y09M
10002,10002020,10002020-024,1458,4509,2134,2375,107Y09M
10002,10002020,10002020-011,563,1363,693,670,107Y09M
10002,10002020,10002020-020,1307,3554,1734,1820,107Y09M
10002,10002020,10002020-018,1244,3598,1701,1897,107Y09M
10002,10002020,10002020-010,663,1878,886,992,107Y09M
10002,10002020,10002020-023,1232,3707,1784,1923,107Y09M
10002,10002020,10002020-017,1210,3447,1648,1799,107Y09M
10002,10002020,10002020-005,1621,4445,2045,2400,107Y09M
10002,10002020,10002020-022,1362,3722,1726,1996,107Y09M
10002,10002020,10002020-008,1120,2802,1333,1469,107Y09M
10002,10002020,10002020-009,591,1649,769,880,107Y09M
10002,10002020,10002020-026,1974,5631,2604,3027,107Y09M
10002,10002020,10002020-028,676,1647,799,848,107Y09M
10002,10002020,10002020-021,700,1468,718,750,107Y09M
10002,10002020,10002020-006,1121,3250,1609,1641,107Y09M
10002,10002020,10002020-016,1741,4765,2250,2515,107Y09M
10002,10002020,10002020-027,1333,3829,1824,2005,107Y09M
10002,10002020,10002020-019,1692,4542,2098,2444,107Y09M
10002,10002020,10002020-025,1530,4389,2035,2354,107Y09M
10002,10002020,10002020-007,1407,3631,1671,1960,107Y09M
10002,10002030,10002030-015,212,515,256,259,107Y09M
10002,10002030,10002030-016,309,660,339,321,107Y09M
10002,10002030,10002030-003,1505,4476,2256,2220,107Y09M
10002,10002030,10002030-017,193,520,249,271,107Y09M
10002,10002030,10002030-004,369,1040,560,480,107Y09M
10002,10002030,10002030-024,142,388,193,195,107Y09M
10002,10002030,10002030-014,242,618,323,295,107Y09M
10002,10002030,10002030-019,389,1048,536,512,107Y09M
10002,10002030,10002030-018,392,1056,544,512,107Y09M
10002,10002030,10002030-020,425,1256,623,633,107Y09M
10002,10002030,10002030-023,462,1384,719,665,107Y09M
10002,10002030,10002030-025,359,831,441,390,107Y09M
10002,10002030,10002030-022,420,1177,593,584,107Y09M
10002,10002030,10002030-021,600,1629,809,820,107Y09M
10002,10002030,10002030-002,360,1152,595,557,107Y09M
10002,10002030,10002030-026,293,649,354,295,107Y09M
10002,10002030,10002030-005,538,1553,823,730,107Y09M
10002,10002030,10002030-008,521,1482,734,748,107Y09M
10002,10002030,10002030-009,894,2680,1358,1322,107Y09M
10002,10002030,10002030-027,1139,3261,1620,1641,107Y09M
10002,10002030,10002030-007,1186,3548,1818,1730,107Y09M
10002,10002030,10002030-001,1325,3870,1989,1881,107Y09M
10002,10002030,10002030-011,457,1168,576,592,107Y09M
10002,10002030,10002030-010,1022,2753,1419,1334,107Y09M
10002,10002030,10002030-013,256,596,302,294,107Y09M
10002,10002030,10002030-012,209,498,249,249,107Y09M
10015,10015030,10015030-014,411,1006,561,445,107Y09M
10015,10015030,10015030-015,478,1263,657,606,107Y09M
10015,10015030,10015030-001,2220,6192,3062,3130,107Y09M
10015,10015030,10015030-003,525,1486,784,702,107Y09M
10015,10015030,10015030-009,234,613,354,259,107Y09M
10015,10015030,10015030-011,620,1722,979,743,107Y09M
10015,10015030,10015030-007,296,757,434,323,107Y09M
10015,10015030,10015030-012,373,991,550,441,107Y09M
10015,10015030,10015030-004,470,1538,848,690,107Y09M
10015,10015030,10015030-005,509,1438,704,734,107Y09M
10015,10015030,10015030-002,773,1908,955,953,107Y09M
10015,10015030,10015030-006,501,1422,780,642,107Y09M
10015,10015030,10015030-013,300,891,503,388,107Y09M
10015,10015030,10015030-008,460,1109,631,478,107Y09M
10015,10015030,10015030-010,694,1755,937,818,107Y09M
10015,10015070,10015070-003,426,1080,563,517,107Y09M
10015,10015070,10015070-007,333,861,464,397,107Y09M
10015,10015070,10015070-005,487,1199,629,570,107Y09M
10015,10015070,10015070-001,391,957,474,483,107Y09M
10015,10015070,10015070-004,477,1147,609,538,107Y09M
10015,10015070,10015070-009,156,355,186,169,107Y09M
10015,10015070,10015070-002,589,1434,766,668,107Y09M
10015,10015070,10015070-006,217,501,271,230,107Y09M
10015,10015070,10015070-008,216,602,320,282,107Y09M
10015,10015070,10015070-010,202,503,291,212,107Y09M
10015,10015070,10015070-014,376,1036,561,475,107Y09M
10015,10015070,10015070-012,411,1075,563,512,107Y09M
10015,10015070,10015070-011,400,1132,614,518,107Y09M
10015,10015070,10015070-013,344,962,506,456,107Y09M
10015,10015050,10015050-009,663,1427,798,629,107Y09M
10015,10015050,10015050-016,1041,2642,1371,1271,107Y09M
10015,10015050,10015050-014,2719,6904,3359,3545,107Y09M
10015,10015050,10015050-017,1930,4967,2597,2370,107Y09M
10015,10015050,10015050-003,1626,4281,2214,2067,107Y09M
10015,10015050,10015050-001,3363,8750,4126,4624,107Y09M
10015,10015050,10015050-004,1873,4708,2331,2377,107Y09M
10015,10015050,10015050-010,1225,3266,1657,1609,107Y09M
10015,10015050,10015050-018,906,2211,1146,1065,107Y09M
10015,10015050,10015050-006,2431,6009,3066,2943,107Y09M
10015,10015050,10015050-013,1741,4657,2295,2362,107Y09M
10015,10015050,10015050-015,2432,6207,3201,3006,107Y09M
10015,10015050,10015050-012,1802,4904,2384,2520,107Y09M
10015,10015050,10015050-008,649,1767,944,823,107Y09M
10015,10015050,10015050-002,2245,5788,2810,2978,107Y09M
10015,10015050,10015050-007,1236,3382,1749,1633,107Y09M
10015,10015050,10015050-005,2961,7737,3979,3758,107Y09M
10015,10015050,10015050-011,1336,3707,1907,1800,107Y09M
10015,10015110,10015110-006,390,1393,721,672,107Y09M
10015,10015110,10015110-004,426,1494,766,728,107Y09M
10015,10015110,10015110-003,707,2232,1089,1143,107Y09M
10015,10015110,10015110-008,368,1230,634,596,107Y09M
10015,10015110,10015110-009,573,1831,959,872,107Y09M
10015,10015110,10015110-001,541,1749,898,851,107Y09M
10015,10015110,10015110-002,695,2247,1165,1082,107Y09M
10015,10015110,10015110-007,707,2199,1130,1069,107Y09M
10015,10015110,10015110-005,432,1538,799,739,107Y09M
10015,10015130,10015130-003,232,888,476,412,107Y09M
10015,10015130,10015130-006,319,1149,631,518,107Y09M
10015,10015130,10015130-002,374,1214,667,547,107Y09M
10015,10015130,10015130-005,341,1278,704,574,107Y09M
10015,10015130,10015130-004,256,897,491,406,107Y09M
10015,10015130,10015130-001,172,677,381,296,107Y09M
10015,10015010,10015010-029,1337,3318,1575,1743,107Y09M
10015,10015010,10015010-013,271,720,349,371,107Y09M
10015,10015010,10015010-042,1145,3142,1485,1657,107Y09M
10015,10015010,10015010-006,1424,3738,1813,1925,107Y09M
10015,10015010,10015010-004,294,719,326,393,107Y09M
10015,10015010,10015010-036,404,991,472,519,107Y09M
10015,10015010,10015010-020,287,783,367,416,107Y09M
10015,10015010,10015010-028,399,1020,488,532,107Y09M
10015,10015010,10015010-005,288,712,352,360,107Y09M
10015,10015010,10015010-012,224,546,276,270,107Y09M
10015,10015010,10015010-014,1603,4429,2136,2293,107Y09M
10015,10015010,10015010-021,866,2394,1143,1251,107Y09M
10015,10015010,10015010-037,2445,6456,3023,3433,107Y09M
10015,10015010,10015010-025,422,1040,553,487,107Y09M
10015,10015010,10015010-027,298,720,348,372,107Y09M
10015,10015010,10015010-019,594,1396,642,754,107Y09M
10015,10015010,10015010-001,743,1841,913,928,107Y09M
10015,10015010,10015010-034,269,776,382,394,107Y09M
10015,10015010,10015010-045,1674,4145,2047,2098,107Y09M
10015,10015010,10015010-033,1439,3441,1667,1774,107Y09M
10015,10015010,10015010-017,1743,4263,1944,2319,107Y09M
10015,10015010,10015010-003,228,564,269,295,107Y09M
10015,10015010,10015010-018,1685,4391,2015,2376,107Y09M
10015,10015010,10015010-010,957,2292,1226,1066,107Y09M
10015,10015010,10015010-002,940,2236,1099,1137,107Y09M
10015,10015010,10015010-009,836,1966,912,1054,107Y09M
10015,10015010,10015010-026,313,704,346,358,107Y09M
10015,10015010,10015010-035,209,533,260,273,107Y09M
10015,10015010,10015010-022,591,1457,739,718,107Y09M
10015,10015010,10015010-030,270,603,302,301,107Y09M
10015,10015010,10015010-039,432,1080,516,564,107Y09M
10015,10015010,10015010-015,482,1228,578,650,107Y09M
10015,10015010,10015010-007,1174,2343,1223,1120,107Y09M
10015,10015010,10015010-008,1580,4440,2053,2387,107Y09M
10015,10015010,10015010-024,744,2062,1002,1060,107Y09M
10015,10015010,10015010-043,2034,4298,2031,2267,107Y09M
10015,10015010,10015010-016,2357,5768,2766,3002,107Y09M
10015,10015010,10015010-038,1110,2956,1431,1525,107Y09M
10015,10015010,10015010-041,1975,4876,2377,2499,107Y09M
10015,10015010,10015010-040,632,1694,880,814,107Y09M
10015,10015010,10015010-031,959,2532,1207,1325,107Y09M
10015,10015010,10015010-032,476,1273,647,626,107Y09M
10015,10015010,10015010-044,1861,4763,2316,2447,107Y09M
10015,10015010,10015010-023,1407,3112,1506,1606,107Y09M
10015,10015100,10015100-010,194,522,281,241,107Y09M
10015,10015100,10015100-007,377,1025,541,484,107Y09M
10015,10015100,10015100-005,501,1232,635,597,107Y09M
10015,10015100,10015100-001,231,535,298,237,107Y09M
10015,10015100,10015100-008,165,440,246,194,107Y09M
10015,10015100,10015100-002,489,1146,634,512,107Y09M
10015,10015100,10015100-009,593,1545,805,740,107Y09M
10015,10015100,10015100-012,216,575,303,272,107Y09M
10015,10015100,10015100-004,289,646,372,274,107Y09M
10015,10015100,10015100-003,244,740,428,312,107Y09M
10015,10015100,10015100-013,272,728,407,321,107Y09M
10015,10015100,10015100-011,290,703,389,314,107Y09M
10015,10015100,10015100-006,182,503,272,231,107Y09M
10015,10015040,10015040-008,1155,3008,1541,1467,107Y09M
10015,10015040,10015040-004,1801,4683,2420,2263,107Y09M
10015,10015040,10015040-005,427,1157,607,550,107Y09M
10015,10015040,10015040-003,1033,2798,1401,1397,107Y09M
10015,10015040,10015040-002,368,1027,572,455,107Y09M
10015,10015040,10015040-001,567,1499,756,743,107Y09M
10015,10015040,10015040-006,1763,4473,2277,2196,107Y09M
10015,10015040,10015040-007,622,1498,746,752,107Y09M
10015,10015090,10015090-008,114,396,216,180,107Y09M
10015,10015090,10015090-010,405,995,550,445,107Y09M
10015,10015090,10015090-009,360,870,481,389,107Y09M
10015,10015090,10015090-011,302,690,405,285,107Y09M
10015,10015090,10015090-005,265,691,372,319,107Y09M
10015,10015090,10015090-003,257,611,327,284,107Y09M
10015,10015090,10015090-002,853,2106,1081,1025,107Y09M
10015,10015090,10015090-004,489,1116,595,521,107Y09M
10015,10015090,10015090-001,937,2187,1168,1019,107Y09M
10015,10015090,10015090-006,434,1090,579,511,107Y09M
10015,10015090,10015090-007,360,983,570,413,107Y09M
10015,10015120,10015120-001,461,1308,671,637,107Y09M
10015,10015120,10015120-002,223,701,369,332,107Y09M
10015,10015120,10015120-004,280,823,441,382,107Y09M
10015,10015120,10015120-006,440,1286,693,593,107Y09M
10015,10015120,10015120-005,387,1361,710,651,107Y09M
10015,10015120,10015120-003,319,971,506,465,107Y09M
10015,10015060,10015060-013,388,963,535,428,107Y09M
10015,10015060,10015060-014,370,831,462,369,107Y09M
10015,10015060,10015060-010,642,1608,838,770,107Y09M
10015,10015060,10015060-008,331,935,510,425,107Y09M
10015,10015060,10015060-006,347,787,412,375,107Y09M
10015,10015060,10015060-009,385,844,458,386,107Y09M
10015,10015060,10015060-012,135,292,162,130,107Y09M
10015,10015060,10015060-011,1225,2970,1528,1442,107Y09M
10015,10015060,10015060-002,437,1172,607,565,107Y09M
10015,10015060,10015060-007,743,1899,997,902,107Y09M
10015,10015060,10015060-001,164,391,218,173,107Y09M
10015,10015060,10015060-003,852,2173,1147,1026,107Y09M
10015,10015060,10015060-005,388,1030,545,485,107Y09M
10015,10015060,10015060-004,582,1590,830,760,107Y09M
10015,10015060,10015060-015,273,549,293,256,107Y09M
10015,10015020,10015020-007,556,1439,761,678,107Y09M
10015,10015020,10015020-006,269,554,294,260,107Y09M
10015,10015020,10015020-008,251,623,340,283,107Y09M
10015,10015020,10015020-010,379,946,479,467,107Y09M
10015,10015020,10015020-011,464,1102,580,522,107Y09M
10015,10015020,10015020-009,263,591,321,270,107Y09M
10015,10015020,10015020-012,37,97,49,48,107Y09M
10015,10015020,10015020-001,514,1354,702,652,107Y09M
10015,10015020,10015020-005,593,1508,798,710,107Y09M
10015,10015020,10015020-004,538,1331,662,669,107Y09M
10015,10015020,10015020-002,288,699,347,352,107Y09M
10015,10015020,10015020-003,257,657,331,326,107Y09M
10015,10015080,10015080-004,318,826,457,369,107Y09M
10015,10015080,10015080-002,265,725,401,324,107Y09M
10015,10015080,10015080-005,268,776,457,319,107Y09M
10015,10015080,10015080-003,168,511,275,236,107Y09M
10015,10015080,10015080-001,707,1977,1074,903,107Y09M
9020,9020020,09020020-002,639,2064,1014,1050,107Y09M
9020,9020020,09020020-003,406,1257,631,626,107Y09M
9020,9020020,09020020-004,867,2640,1312,1328,107Y09M
9020,9020020,09020020-006,482,1681,869,812,107Y09M
9020,9020020,09020020-005,675,2227,1097,1130,107Y09M
9020,9020020,09020020-001,1817,5834,2883,2951,107Y09M
9020,9020020,09020020-007,690,2382,1171,1211,107Y09M
9020,9020020,09020020-008,772,2647,1277,1370,107Y09M
9020,9020010,09020010-004,1421,4714,2417,2297,107Y09M
9020,9020010,09020010-005,1286,4267,2129,2138,107Y09M
9020,9020010,09020010-002,3475,11509,5602,5907,107Y09M
9020,9020010,09020010-001,1705,5773,2854,2919,107Y09M
9020,9020010,09020010-006,690,2353,1218,1135,107Y09M
9020,9020010,09020010-003,1921,6313,3085,3228,107Y09M
9020,9020010,09020010-007,958,3181,1617,1564,107Y09M
9020,9020010,09020010-008,1521,5177,2639,2538,107Y09M
9020,9020030,09020030-002,1121,3801,1839,1962,107Y09M
9020,9020030,09020030-003,869,2924,1453,1471,107Y09M
9020,9020030,09020030-004,590,2208,1170,1038,107Y09M
9020,9020030,09020030-001,1535,4766,2360,2406,107Y09M
9020,9020030,09020030-006,2771,8836,4496,4340,107Y09M
9020,9020030,09020030-007,507,1687,854,833,107Y09M
9020,9020030,09020030-008,565,1794,886,908,107Y09M
9020,9020030,09020030-005,1053,3607,1789,1818,107Y09M
9020,9020040,09020040-001,1079,3593,1787,1806,107Y09M
9020,9020040,09020040-003,528,1717,839,878,107Y09M
9020,9020040,09020040-002,1572,5104,2562,2542,107Y09M
9020,9020040,09020040-004,2148,8198,4257,3941,107Y09M
9020,9020040,09020040-005,1727,5833,2960,2873,107Y09M
9020,9020040,09020040-006,1737,7105,3500,3605,107Y09M
9020,9020050,09020050-001,735,3134,1508,1626,107Y09M
9020,9020050,09020050-002,431,1564,738,826,107Y09M
9020,9020050,09020050-003,651,2619,1272,1347,107Y09M
9020,9020050,09020050-004,935,3755,1967,1788,107Y09M
9020,9020050,09020050-005,428,1776,849,927,107Y09M
9020,9020060,09020060-001,53,319,170,149,107Y09M
9020,9020060,09020060-002,82,365,177,188,107Y09M
10008,10008080,10008080-003,349,905,484,421,107Y09M
10008,10008080,10008080-008,258,745,406,339,107Y09M
10008,10008080,10008080-016,209,518,290,228,107Y09M
10008,10008080,10008080-006,724,1980,1008,972,107Y09M
10008,10008080,10008080-015,225,570,340,230,107Y09M
10008,10008080,10008080-017,197,498,274,224,107Y09M
10008,10008080,10008080-010,562,1502,773,729,107Y09M
10008,10008080,10008080-004,301,732,411,321,107Y09M
10008,10008080,10008080-002,199,522,302,220,107Y09M
10008,10008080,10008080-012,375,998,557,441,107Y09M
10008,10008080,10008080-018,218,529,296,233,107Y09M
10008,10008080,10008080-007,110,319,165,154,107Y09M
10008,10008080,10008080-011,402,1205,643,562,107Y09M
10008,10008080,10008080-005,337,765,425,340,107Y09M
10008,10008080,10008080-009,227,557,318,239,107Y09M
10008,10008080,10008080-001,358,910,493,417,107Y09M
10008,10008080,10008080-013,297,761,418,343,107Y09M
10008,10008080,10008080-014,287,729,398,331,107Y09M
10008,10008130,10008130-005,192,643,324,319,107Y09M
10008,10008130,10008130-009,690,1975,1003,972,107Y09M
10008,10008130,10008130-002,315,1210,577,633,107Y09M
10008,10008130,10008130-003,433,1399,718,681,107Y09M
10008,10008130,10008130-007,229,804,406,398,107Y09M
10008,10008130,10008130-001,248,1065,577,488,107Y09M
10008,10008130,10008130-010,456,1543,801,742,107Y09M
10008,10008130,10008130-011,355,1245,625,620,107Y09M
10008,10008130,10008130-016,249,811,435,376,107Y09M
10008,10008130,10008130-006,362,946,490,456,107Y09M
10008,10008130,10008130-004,142,479,247,232,107Y09M
10008,10008130,10008130-013,209,841,440,401,107Y09M
10008,10008130,10008130-014,34,59,35,24,107Y09M
10008,10008130,10008130-012,266,856,450,406,107Y09M
10008,10008130,10008130-015,250,622,329,293,107Y09M
10008,10008130,10008130-008,460,1463,788,675,107Y09M
10008,10008110,10008110-014,511,1210,653,557,107Y09M
10008,10008110,10008110-004,286,695,355,340,107Y09M
10008,10008110,10008110-001,335,830,440,390,107Y09M
10008,10008110,10008110-006,487,1152,578,574,107Y09M
10008,10008110,10008110-015,429,974,556,418,107Y09M
10008,10008110,10008110-016,161,362,198,164,107Y09M
10008,10008110,10008110-008,564,1596,820,776,107Y09M
10008,10008110,10008110-017,383,906,505,401,107Y09M
10008,10008110,10008110-010,232,498,277,221,107Y09M
10008,10008110,10008110-019,668,1829,890,939,107Y09M
10008,10008110,10008110-005,447,1024,532,492,107Y09M
10008,10008110,10008110-013,154,380,225,155,107Y09M
10008,10008110,10008110-009,550,1399,702,697,107Y09M
10008,10008110,10008110-012,88,236,133,103,107Y09M
10008,10008110,10008110-003,703,1799,945,854,107Y09M
10008,10008110,10008110-011,305,735,401,334,107Y09M
10008,10008110,10008110-002,215,542,272,270,107Y09M
10008,10008110,10008110-007,462,1156,583,573,107Y09M
10008,10008110,10008110-018,143,300,178,122,107Y09M
10008,10008060,10008060-012,354,1052,568,484,107Y09M
10008,10008060,10008060-016,547,1817,964,853,107Y09M
10008,10008060,10008060-011,688,2075,1097,978,107Y09M
10008,10008060,10008060-013,273,851,440,411,107Y09M
10008,10008060,10008060-003,846,2602,1364,1238,107Y09M
10008,10008060,10008060-002,1332,4030,2057,1973,107Y09M
10008,10008060,10008060-023,334,1004,510,494,107Y09M
10008,10008060,10008060-010,467,1435,795,640,107Y09M
10008,10008060,10008060-014,343,1051,574,477,107Y09M
10008,10008060,10008060-015,442,1305,707,598,107Y09M
10008,10008060,10008060-008,625,1871,979,892,107Y09M
10008,10008060,10008060-017,567,1752,914,838,107Y09M
10008,10008060,10008060-018,419,1383,732,651,107Y09M
10008,10008060,10008060-001,431,1202,609,593,107Y09M
10008,10008060,10008060-005,350,1148,612,536,107Y09M
10008,10008060,10008060-019,333,1010,540,470,107Y09M
10008,10008060,10008060-020,333,999,523,476,107Y09M
10008,10008060,10008060-006,378,1124,620,504,107Y09M
10008,10008060,10008060-022,645,2013,1073,940,107Y09M
10008,10008060,10008060-021,314,886,475,411,107Y09M
10008,10008060,10008060-007,1625,4908,2531,2377,107Y09M
10008,10008060,10008060-009,364,1050,571,479,107Y09M
10008,10008060,10008060-004,610,1816,972,844,107Y09M
10008,10008040,10008040-005,725,2015,1002,1013,107Y09M
10008,10008040,10008040-006,521,1395,725,670,107Y09M
10008,10008040,10008040-019,265,486,264,222,107Y09M
10008,10008040,10008040-015,747,2138,1120,1018,107Y09M
10008,10008040,10008040-003,1997,5311,2678,2633,107Y09M
10008,10008040,10008040-017,496,1326,712,614,107Y09M
10008,10008040,10008040-002,306,700,357,343,107Y09M
10008,10008040,10008040-008,380,1106,599,507,107Y09M
10008,10008040,10008040-009,599,1595,815,780,107Y09M
10008,10008040,10008040-020,263,684,359,325,107Y09M
10008,10008040,10008040-001,939,2318,1145,1173,107Y09M
10008,10008040,10008040-028,1041,2767,1353,1414,107Y09M
10008,10008040,10008040-026,302,795,439,356,107Y09M
10008,10008040,10008040-024,197,497,271,226,107Y09M
10008,10008040,10008040-013,366,982,512,470,107Y09M
10008,10008040,10008040-011,1215,3348,1740,1608,107Y09M
10008,10008040,10008040-012,674,1984,1036,948,107Y09M
10008,10008040,10008040-014,2063,5940,2948,2992,107Y09M
10008,10008040,10008040-027,1483,4265,2161,2104,107Y09M
10008,10008040,10008040-016,476,1576,822,754,107Y09M
10008,10008040,10008040-007,1560,4415,2247,2168,107Y09M
10008,10008040,10008040-025,389,999,560,439,107Y09M
10008,10008040,10008040-018,255,673,380,293,107Y09M
10008,10008040,10008040-004,1629,4219,2113,2106,107Y09M
10008,10008040,10008040-023,269,642,373,269,107Y09M
10008,10008040,10008040-021,266,667,351,316,107Y09M
10008,10008040,10008040-010,358,1000,491,509,107Y09M
10008,10008040,10008040-022,362,883,485,398,107Y09M
10008,10008120,10008120-001,422,1521,819,702,107Y09M
10008,10008120,10008120-009,628,1662,908,754,107Y09M
10008,10008120,10008120-002,328,1143,603,540,107Y09M
10008,10008120,10008120-006,314,839,448,391,107Y09M
10008,10008120,10008120-004,659,1730,894,836,107Y09M
10008,10008120,10008120-011,365,1274,666,608,107Y09M
10008,10008120,10008120-010,315,771,447,324,107Y09M
10008,10008120,10008120-008,577,1884,1011,873,107Y09M
10008,10008120,10008120-005,221,582,334,248,107Y09M
10008,10008120,10008120-013,199,757,416,341,107Y09M
10008,10008120,10008120-003,218,797,417,380,107Y09M
10008,10008120,10008120-014,274,771,400,371,107Y09M
10008,10008120,10008120-012,235,814,433,381,107Y09M
10008,10008120,10008120-007,519,1728,915,813,107Y09M
10008,10008010,10008010-003,345,970,481,489,107Y09M
10008,10008010,10008010-016,1194,3352,1664,1688,107Y09M
10008,10008010,10008010-015,2206,6496,3218,3278,107Y09M
10008,10008010,10008010-014,366,1172,607,565,107Y09M
10008,10008010,10008010-004,216,597,287,310,107Y09M
10008,10008010,10008010-030,557,1702,929,773,107Y09M
10008,10008010,10008010-029,2732,7997,3961,4036,107Y09M
10008,10008010,10008010-023,2167,6264,3086,3178,107Y09M
10008,10008010,10008010-012,2647,6977,3365,3612,107Y09M
10008,10008010,10008010-020,270,904,500,404,107Y09M
10008,10008010,10008010-025,1108,3319,1724,1595,107Y09M
10008,10008010,10008010-033,509,1120,478,642,107Y09M
10008,10008010,10008010-031,415,979,436,543,107Y09M
10008,10008010,10008010-032,548,1204,584,620,107Y09M
10008,10008010,10008010-034,232,654,315,339,107Y09M
10008,10008010,10008010-011,167,450,248,202,107Y09M
10008,10008010,10008010-005,265,667,342,325,107Y09M
10008,10008010,10008010-010,1866,5566,2759,2807,107Y09M
10008,10008010,10008010-013,805,2417,1270,1147,107Y09M
10008,10008010,10008010-007,429,1145,568,577,107Y09M
10008,10008010,10008010-002,650,1694,829,865,107Y09M
10008,10008010,10008010-024,1984,5867,2938,2929,107Y09M
10008,10008010,10008010-018,1869,5189,2608,2581,107Y09M
10008,10008010,10008010-017,823,2435,1253,1182,107Y09M
10008,10008010,10008010-006,166,432,201,231,107Y09M
10008,10008010,10008010-009,2801,8280,4147,4133,107Y09M
10008,10008010,10008010-008,1095,3070,1534,1536,107Y09M
10008,10008010,10008010-019,691,2195,1162,1033,107Y09M
10008,10008010,10008010-026,1258,3494,1778,1716,107Y09M
10008,10008010,10008010-022,423,1232,687,545,107Y09M
10008,10008010,10008010-021,266,712,398,314,107Y09M
10008,10008010,10008010-001,403,1091,537,554,107Y09M
10008,10008010,10008010-027,2531,7211,3519,3692,107Y09M
10008,10008010,10008010-028,910,2714,1421,1293,107Y09M
10008,10008020,10008020-022,262,1066,440,626,107Y09M
10008,10008020,10008020-008,2520,6647,3229,3418,107Y09M
10008,10008020,10008020-027,703,1878,931,947,107Y09M
10008,10008020,10008020-011,1563,4477,2223,2254,107Y09M
10008,10008020,10008020-026,1119,3240,1643,1597,107Y09M
10008,10008020,10008020-030,1339,3834,1833,2001,107Y09M
10008,10008020,10008020-004,1151,2916,1455,1461,107Y09M
10008,10008020,10008020-032,1346,3844,1918,1926,107Y09M
10008,10008020,10008020-024,238,666,340,326,107Y09M
10008,10008020,10008020-005,939,2610,1272,1338,107Y09M
10008,10008020,10008020-021,262,755,402,353,107Y09M
10008,10008020,10008020-029,620,1924,975,949,107Y09M
10008,10008020,10008020-016,137,336,201,135,107Y09M
10008,10008020,10008020-003,1348,3710,1828,1882,107Y09M
10008,10008020,10008020-020,510,1598,838,760,107Y09M
10008,10008020,10008020-001,1235,3098,1514,1584,107Y09M
10008,10008020,10008020-031,1090,3147,1535,1612,107Y09M
10008,10008020,10008020-010,3252,9016,4470,4546,107Y09M
10008,10008020,10008020-017,533,1637,826,811,107Y09M
10008,10008020,10008020-002,374,915,463,452,107Y09M
10008,10008020,10008020-015,474,1137,617,520,107Y09M
10008,10008020,10008020-033,903,2497,1211,1286,107Y09M
10008,10008020,10008020-013,418,1338,715,623,107Y09M
10008,10008020,10008020-007,1578,4250,2134,2116,107Y09M
10008,10008020,10008020-018,623,1698,831,867,107Y09M
10008,10008020,10008020-014,434,1379,671,708,107Y09M
10008,10008020,10008020-028,1100,2989,1538,1451,107Y09M
10008,10008020,10008020-025,417,1133,571,562,107Y09M
10008,10008020,10008020-023,453,1295,650,645,107Y09M
10008,10008020,10008020-006,479,1138,563,575,107Y09M
10008,10008020,10008020-012,440,1176,619,557,107Y09M
10008,10008020,10008020-009,365,1051,534,517,107Y09M
10008,10008020,10008020-019,740,2071,1067,1004,107Y09M
10008,10008030,10008030-012,1222,3603,1842,1761,107Y09M
10008,10008030,10008030-020,657,1891,999,892,107Y09M
10008,10008030,10008030-005,3103,8568,4179,4389,107Y09M
10008,10008030,10008030-025,1034,2817,1379,1438,107Y09M
10008,10008030,10008030-024,318,790,402,388,107Y09M
10008,10008030,10008030-018,752,2402,1251,1151,107Y09M
10008,10008030,10008030-016,809,2585,1338,1247,107Y09M
10008,10008030,10008030-014,1083,3403,1746,1657,107Y09M
10008,10008030,10008030-017,703,2217,1186,1031,107Y09M
10008,10008030,10008030-023,399,1245,635,610,107Y09M
10008,10008030,10008030-001,906,2521,1235,1286,107Y09M
10008,10008030,10008030-015,585,1759,933,826,107Y09M
10008,10008030,10008030-003,493,1323,674,649,107Y09M
10008,10008030,10008030-021,400,1161,622,539,107Y09M
10008,10008030,10008030-026,1626,4485,2199,2286,107Y09M
10008,10008030,10008030-002,970,2510,1206,1304,107Y09M
10008,10008030,10008030-019,1596,4801,2449,2352,107Y09M
10008,10008030,10008030-007,2410,7063,3568,3495,107Y09M
10008,10008030,10008030-006,2795,7830,3898,3932,107Y09M
10008,10008030,10008030-011,1054,3381,1764,1617,107Y09M
10008,10008030,10008030-004,2577,7667,3837,3830,107Y09M
10008,10008030,10008030-013,1347,4039,2092,1947,107Y09M
10008,10008030,10008030-027,1409,3825,1856,1969,107Y09M
10008,10008030,10008030-008,1493,4740,2464,2276,107Y09M
10008,10008030,10008030-010,944,2792,1389,1403,107Y09M
10008,10008030,10008030-009,1723,5223,2655,2568,107Y09M
10008,10008030,10008030-022,921,2632,1404,1228,107Y09M
10008,10008100,10008100-012,317,800,456,344,107Y09M
10008,10008100,10008100-003,313,764,440,324,107Y09M
10008,10008100,10008100-010,637,1734,932,802,107Y09M
10008,10008100,10008100-004,848,2106,1140,966,107Y09M
10008,10008100,10008100-002,777,2084,1058,1026,107Y09M
10008,10008100,10008100-005,613,1575,844,731,107Y09M
10008,10008100,10008100-006,347,799,438,361,107Y09M
10008,10008100,10008100-013,381,838,480,358,107Y09M
10008,10008100,10008100-011,687,1820,1050,770,107Y09M
10008,10008100,10008100-009,486,1278,665,613,107Y09M
10008,10008100,10008100-008,349,894,494,400,107Y09M
10008,10008100,10008100-001,779,1970,1030,940,107Y09M
10008,10008100,10008100-007,771,2051,1054,997,107Y09M
10008,10008090,10008090-005,451,1249,675,574,107Y09M
10008,10008090,10008090-008,285,751,403,348,107Y09M
10008,10008090,10008090-003,423,1143,602,541,107Y09M
10008,10008090,10008090-009,289,821,457,364,107Y09M
10008,10008090,10008090-013,354,977,474,503,107Y09M
10008,10008090,10008090-010,355,973,497,476,107Y09M
10008,10008090,10008090-007,385,1112,591,521,107Y09M
10008,10008090,10008090-006,496,1432,786,646,107Y09M
10008,10008090,10008090-001,654,1792,946,846,107Y09M
10008,10008090,10008090-012,270,626,334,292,107Y09M
10008,10008090,10008090-002,833,2336,1182,1154,107Y09M
10008,10008090,10008090-004,585,1592,820,772,107Y09M
10008,10008090,10008090-011,378,1018,570,448,107Y09M
10008,10008070,10008070-005,506,1170,634,536,107Y09M
10008,10008070,10008070-010,887,1812,972,840,107Y09M
10008,10008070,10008070-006,764,1688,915,773,107Y09M
10008,10008070,10008070-007,466,1005,560,445,107Y09M
10008,10008070,10008070-011,433,856,484,372,107Y09M
10008,10008070,10008070-008,307,679,375,304,107Y09M
10008,10008070,10008070-002,786,1591,834,757,107Y09M
10008,10008070,10008070-012,394,780,442,338,107Y09M
10008,10008070,10008070-001,978,2135,1094,1041,107Y09M
10008,10008070,10008070-013,321,822,446,376,107Y09M
10008,10008070,10008070-003,630,1466,737,729,107Y09M
10008,10008070,10008070-009,628,1552,806,746,107Y09M
10008,10008070,10008070-004,939,2144,1133,1011,107Y09M
10008,10008050,10008050-008,641,1679,858,821,107Y09M
10008,10008050,10008050-009,428,1080,562,518,107Y09M
10008,10008050,10008050-006,229,589,289,300,107Y09M
10008,10008050,10008050-004,526,1379,749,630,107Y09M
10008,10008050,10008050-007,455,1009,517,492,107Y09M
10008,10008050,10008050-002,421,1039,541,498,107Y09M
10008,10008050,10008050-003,245,635,349,286,107Y09M
10008,10008050,10008050-010,235,643,344,299,107Y09M
10008,10008050,10008050-001,501,1225,622,603,107Y09M
10008,10008050,10008050-005,235,544,291,253,107Y09M
10008,10008050,10008050-011,398,1041,531,510,107Y09M
10013,10013080,10013080-003,665,1989,1061,928,107Y09M
10013,10013080,10013080-001,533,1699,853,846,107Y09M
10013,10013080,10013080-002,497,1588,800,788,107Y09M
10013,10013080,10013080-006,558,1852,969,883,107Y09M
10013,10013080,10013080-005,436,1350,709,641,107Y09M
10013,10013080,10013080-004,469,1467,770,697,107Y09M
10013,10013080,10013080-011,611,1844,965,879,107Y09M
10013,10013080,10013080-010,1725,5119,2579,2540,107Y09M
10013,10013080,10013080-007,628,2075,1073,1002,107Y09M
10013,10013080,10013080-009,492,1706,884,822,107Y09M
10013,10013080,10013080-008,449,1410,757,653,107Y09M
10013,10013260,10013260-001,504,1685,831,854,107Y09M
10013,10013260,10013260-006,203,700,326,374,107Y09M
10013,10013260,10013260-004,241,742,397,345,107Y09M
10013,10013260,10013260-008,169,582,298,284,107Y09M
10013,10013260,10013260-009,270,849,429,420,107Y09M
10013,10013260,10013260-010,231,753,373,380,107Y09M
10013,10013260,10013260-007,128,417,209,208,107Y09M
10013,10013260,10013260-002,132,401,213,188,107Y09M
10013,10013260,10013260-003,205,677,348,329,107Y09M
10013,10013260,10013260-005,249,889,435,454,107Y09M
10013,10013130,10013130-014,408,1228,649,579,107Y09M
10013,10013130,10013130-020,696,2001,1042,959,107Y09M
10013,10013130,10013130-016,606,1814,957,857,107Y09M
10013,10013130,10013130-002,1329,3568,1771,1797,107Y09M
10013,10013130,10013130-001,1770,4548,2282,2266,107Y09M
10013,10013130,10013130-023,375,923,460,463,107Y09M
10013,10013130,10013130-011,675,2079,1109,970,107Y09M
10013,10013130,10013130-015,938,2707,1424,1283,107Y09M
10013,10013130,10013130-006,1100,3172,1567,1605,107Y09M
10013,10013130,10013130-013,347,1035,524,511,107Y09M
10013,10013130,10013130-012,1095,3246,1704,1542,107Y09M
10013,10013130,10013130-007,1807,5099,2550,2549,107Y09M
10013,10013130,10013130-019,274,959,573,386,107Y09M
10013,10013130,10013130-005,901,2460,1289,1171,107Y09M
10013,10013130,10013130-009,597,1893,1012,881,107Y09M
10013,10013130,10013130-010,721,2132,1169,963,107Y09M
10013,10013130,10013130-004,244,667,343,324,107Y09M
10013,10013130,10013130-022,502,1520,792,728,107Y09M
10013,10013130,10013130-021,810,2859,1465,1394,107Y09M
10013,10013130,10013130-003,486,1464,797,667,107Y09M
10013,10013130,10013130-017,927,2836,1466,1370,107Y09M
10013,10013130,10013130-018,985,2784,1389,1395,107Y09M
10013,10013130,10013130-008,1091,3206,1644,1562,107Y09M
10013,10013140,10013140-006,356,1114,578,536,107Y09M
10013,10013140,10013140-014,425,1388,716,672,107Y09M
10013,10013140,10013140-012,264,889,474,415,107Y09M
10013,10013140,10013140-011,411,954,569,385,107Y09M
10013,10013140,10013140-001,621,1673,907,766,107Y09M
10013,10013140,10013140-002,325,976,499,477,107Y09M
10013,10013140,10013140-009,911,2789,1474,1315,107Y09M
10013,10013140,10013140-013,417,1254,652,602,107Y09M
10013,10013140,10013140-008,179,530,270,260,107Y09M
10013,10013140,10013140-007,228,713,389,324,107Y09M
10013,10013140,10013140-010,170,557,292,265,107Y09M
10013,10013140,10013140-015,411,1395,700,695,107Y09M
10013,10013140,10013140-004,217,658,362,296,107Y09M
10013,10013140,10013140-005,479,1474,811,663,107Y09M
10013,10013140,10013140-003,247,808,432,376,107Y09M
10013,10013330,10013330-006,255,632,358,274,107Y09M
10013,10013330,10013330-001,765,1944,943,1001,107Y09M
10013,10013330,10013330-004,200,439,224,215,107Y09M
10013,10013330,10013330-002,309,818,403,415,107Y09M
10013,10013330,10013330-003,184,502,265,237,107Y09M
10013,10013330,10013330-005,234,675,344,331,107Y09M
10013,10013230,10013230-003,277,736,399,337,107Y09M
10013,10013230,10013230-007,580,1380,756,624,107Y09M
10013,10013230,10013230-011,217,464,244,220,107Y09M
10013,10013230,10013230-009,169,476,279,197,107Y09M
10013,10013230,10013230-010,212,596,330,266,107Y09M
10013,10013230,10013230-004,340,820,444,376,107Y09M
10013,10013230,10013230-005,174,433,225,208,107Y09M
10013,10013230,10013230-008,174,471,238,233,107Y09M
10013,10013230,10013230-006,423,1042,564,478,107Y09M
10013,10013230,10013230-002,279,631,337,294,107Y09M
10013,10013230,10013230-001,639,1591,822,769,107Y09M
10013,10013090,10013090-012,631,2160,1107,1053,107Y09M
10013,10013090,10013090-011,767,2309,1204,1105,107Y09M
10013,10013090,10013090-002,456,1302,642,660,107Y09M
10013,10013090,10013090-013,343,1129,590,539,107Y09M
10013,10013090,10013090-003,328,990,519,471,107Y09M
10013,10013090,10013090-001,1170,3712,1846,1866,107Y09M
10013,10013090,10013090-004,502,1524,758,766,107Y09M
10013,10013090,10013090-009,610,1811,949,862,107Y09M
10013,10013090,10013090-007,548,1804,927,877,107Y09M
10013,10013090,10013090-010,819,2826,1417,1409,107Y09M
10013,10013090,10013090-005,795,2432,1211,1221,107Y09M
10013,10013090,10013090-008,541,1880,971,909,107Y09M
10013,10013090,10013090-014,176,556,310,246,107Y09M
10013,10013090,10013090-006,524,1687,839,848,107Y09M
10013,10013210,10013210-009,452,1317,708,609,107Y09M
10013,10013210,10013210-002,587,1504,798,706,107Y09M
10013,10013210,10013210-006,853,2404,1242,1162,107Y09M
10013,10013210,10013210-005,769,2196,1162,1034,107Y09M
10013,10013210,10013210-001,637,1647,832,815,107Y09M
10013,10013210,10013210-007,398,1086,575,511,107Y09M
10013,10013210,10013210-010,438,1255,640,615,107Y09M
10013,10013210,10013210-012,997,2841,1458,1383,107Y09M
10013,10013210,10013210-004,714,1978,1018,960,107Y09M
10013,10013210,10013210-011,484,1272,653,619,107Y09M
10013,10013210,10013210-003,340,891,467,424,107Y09M
10013,10013210,10013210-008,305,795,420,375,107Y09M
10013,10013300,10013300-003,257,869,433,436,107Y09M
10013,10013300,10013300-005,296,1021,489,532,107Y09M
10013,10013300,10013300-004,391,1290,657,633,107Y09M
10013,10013300,10013300-001,342,1093,552,541,107Y09M
10013,10013300,10013300-007,451,1423,748,675,107Y09M
10013,10013300,10013300-006,301,1058,517,541,107Y09M
10013,10013300,10013300-002,192,686,357,329,107Y09M
10013,10013250,10013250-002,758,2210,1117,1093,107Y09M
10013,10013250,10013250-001,445,1165,634,531,107Y09M
10013,10013250,10013250-004,441,984,558,426,107Y09M
10013,10013250,10013250-003,457,1177,630,547,107Y09M
10013,10013160,10013160-009,858,2368,1228,1140,107Y09M
10013,10013160,10013160-015,231,699,352,347,107Y09M
10013,10013160,10013160-004,255,703,380,323,107Y09M
10013,10013160,10013160-010,292,813,474,339,107Y09M
10013,10013160,10013160-007,751,2211,1135,1076,107Y09M
10013,10013160,10013160-012,400,1068,590,478,107Y09M
10013,10013160,10013160-013,173,507,265,242,107Y09M
10013,10013160,10013160-008,586,1630,826,804,107Y09M
10013,10013160,10013160-005,622,1870,1006,864,107Y09M
10013,10013160,10013160-001,570,1382,717,665,107Y09M
10013,10013160,10013160-014,1078,3121,1630,1491,107Y09M
10013,10013160,10013160-003,374,1099,587,512,107Y09M
10013,10013160,10013160-006,1638,4881,2511,2370,107Y09M
10013,10013160,10013160-011,339,1015,545,470,107Y09M
10013,10013160,10013160-002,382,1040,520,520,107Y09M
10013,10013030,10013030-008,346,953,494,459,107Y09M
10013,10013030,10013030-017,699,2316,1223,1093,107Y09M
10013,10013030,10013030-018,610,1797,925,872,107Y09M
10013,10013030,10013030-006,338,824,393,431,107Y09M
10013,10013030,10013030-022,347,861,435,426,107Y09M
10013,10013030,10013030-004,296,776,401,375,107Y09M
10013,10013030,10013030-009,498,1463,764,699,107Y09M
10013,10013030,10013030-015,701,1895,1026,869,107Y09M
10013,10013030,10013030-011,552,1638,848,790,107Y09M
10013,10013030,10013030-016,2469,6659,3289,3370,107Y09M
10013,10013030,10013030-003,175,449,230,219,107Y09M
10013,10013030,10013030-002,233,625,332,293,107Y09M
10013,10013030,10013030-007,711,1941,1005,936,107Y09M
10013,10013030,10013030-001,888,2369,1158,1211,107Y09M
10013,10013030,10013030-014,682,2152,1084,1068,107Y09M
10013,10013030,10013030-005,231,604,323,281,107Y09M
10013,10013030,10013030-021,403,1274,636,638,107Y09M
10013,10013030,10013030-019,3918,11176,5540,5636,107Y09M
10013,10013030,10013030-020,604,1589,826,763,107Y09M
10013,10013030,10013030-012,693,2219,1111,1108,107Y09M
10013,10013030,10013030-010,265,682,344,338,107Y09M
10013,10013030,10013030-013,1152,3430,1723,1707,107Y09M
10013,10013190,10013190-004,327,799,399,400,107Y09M
10013,10013190,10013190-003,742,1845,908,937,107Y09M
10013,10013190,10013190-006,750,2120,1102,1018,107Y09M
10013,10013190,10013190-005,1354,3657,1846,1811,107Y09M
10013,10013190,10013190-008,386,1095,541,554,107Y09M
10013,10013190,10013190-002,730,1796,917,879,107Y09M
10013,10013190,10013190-009,830,2203,1150,1053,107Y09M
10013,10013190,10013190-001,616,1650,841,809,107Y09M
10013,10013190,10013190-007,532,1430,747,683,107Y09M
10013,10013190,10013190-010,429,1257,672,585,107Y09M
10013,10013060,10013060-005,462,1201,619,582,107Y09M
10013,10013060,10013060-004,1148,2943,1472,1471,107Y09M
10013,10013060,10013060-009,636,1848,985,863,107Y09M
10013,10013060,10013060-008,594,1647,872,775,107Y09M
10013,10013060,10013060-001,1051,2952,1535,1417,107Y09M
10013,10013060,10013060-002,1456,4021,2085,1936,107Y09M
10013,10013060,10013060-016,296,793,386,407,107Y09M
10013,10013060,10013060-006,354,982,539,443,107Y09M
10013,10013060,10013060-007,385,1207,617,590,107Y09M
10013,10013060,10013060-011,300,856,445,411,107Y09M
10013,10013060,10013060-010,409,1332,712,620,107Y09M
10013,10013060,10013060-003,758,2277,1154,1123,107Y09M
10013,10013060,10013060-013,568,2008,1069,939,107Y09M
10013,10013060,10013060-012,849,2745,1454,1291,107Y09M
10013,10013060,10013060-015,415,1289,669,620,107Y09M
10013,10013060,10013060-014,490,1628,880,748,107Y09M
10013,10013200,10013200-005,382,1181,607,574,107Y09M
10013,10013200,10013200-003,208,522,256,266,107Y09M
10013,10013200,10013200-009,393,1104,560,544,107Y09M
10013,10013200,10013200-007,390,1159,608,551,107Y09M
10013,10013200,10013200-010,221,597,303,294,107Y09M
10013,10013200,10013200-004,288,784,394,390,107Y09M
10013,10013200,10013200-002,403,1068,548,520,107Y09M
10013,10013200,10013200-001,669,1892,970,922,107Y09M
10013,10013200,10013200-006,358,1127,579,548,107Y09M
10013,10013200,10013200-008,402,1222,618,604,107Y09M
10013,10013010,10013010-036,617,1407,663,744,107Y09M
10013,10013010,10013010-076,475,1510,766,744,107Y09M
10013,10013010,10013010-004,265,653,321,332,107Y09M
10013,10013010,10013010-053,3513,9550,4677,4873,107Y09M
10013,10013010,10013010-051,457,1386,736,650,107Y09M
10013,10013010,10013010-008,299,807,417,390,107Y09M
10013,10013010,10013010-026,4048,11079,5350,5729,107Y09M
10013,10013010,10013010-046,641,2008,1034,974,107Y09M
10013,10013010,10013010-064,2089,5567,2700,2867,107Y09M
10013,10013010,10013010-070,981,2651,1252,1399,107Y09M
10013,10013010,10013010-078,407,1254,682,572,107Y09M
10013,10013010,10013010-042,514,1753,871,882,107Y09M
10013,10013010,10013010-063,322,762,376,386,107Y09M
10013,10013010,10013010-002,135,284,130,154,107Y09M
10013,10013010,10013010-068,1038,2772,1353,1419,107Y09M
10013,10013010,10013010-069,2669,7240,3488,3752,107Y09M
10013,10013010,10013010-014,313,728,372,356,107Y09M
10013,10013010,10013010-009,253,656,323,333,107Y09M
10013,10013010,10013010-007,267,643,314,329,107Y09M
10013,10013010,10013010-050,424,1181,633,548,107Y09M
10013,10013010,10013010-040,3061,8307,4078,4229,107Y09M
10013,10013010,10013010-058,99,228,118,110,107Y09M
10013,10013010,10013010-066,907,2237,1094,1143,107Y09M
10013,10013010,10013010-057,156,370,188,182,107Y09M
10013,10013010,10013010-044,496,1731,908,823,107Y09M
10013,10013010,10013010-039,341,771,431,340,107Y09M
10013,10013010,10013010-001,334,854,408,446,107Y09M
10013,10013010,10013010-013,220,508,246,262,107Y09M
10013,10013010,10013010-049,832,2314,1172,1142,107Y09M
10013,10013010,10013010-016,270,642,320,322,107Y09M
10013,10013010,10013010-079,391,1134,579,555,107Y09M
10013,10013010,10013010-062,343,777,364,413,107Y09M
10013,10013010,10013010-003,142,334,167,167,107Y09M
10013,10013010,10013010-074,829,1907,905,1002,107Y09M
10013,10013010,10013010-018,306,745,359,386,107Y09M
10013,10013010,10013010-056,835,2244,1188,1056,107Y09M
10013,10013010,10013010-022,890,2357,1116,1241,107Y09M
10013,10013010,10013010-080,589,1758,933,825,107Y09M
10013,10013010,10013010-054,1104,3368,1742,1626,107Y09M
10013,10013010,10013010-033,1250,3303,1638,1665,107Y09M
10013,10013010,10013010-035,462,1079,525,554,107Y09M
10013,10013010,10013010-047,175,445,232,213,107Y09M
10013,10013010,10013010-005,233,527,259,268,107Y09M
10013,10013010,10013010-077,303,992,520,472,107Y09M
10013,10013010,10013010-081,1474,3448,1646,1802,107Y09M
10013,10013010,10013010-010,187,458,238,220,107Y09M
10013,10013010,10013010-011,133,343,183,160,107Y09M
10013,10013010,10013010-073,5266,14427,7015,7412,107Y09M
10013,10013010,10013010-055,1758,4735,2324,2411,107Y09M
10013,10013010,10013010-032,199,603,326,277,107Y09M
10013,10013010,10013010-045,392,1275,674,601,107Y09M
10013,10013010,10013010-065,2776,6307,3193,3114,107Y09M
10013,10013010,10013010-019,173,461,237,224,107Y09M
10013,10013010,10013010-059,806,2027,968,1059,107Y09M
10013,10013010,10013010-027,558,1751,916,835,107Y09M
10013,10013010,10013010-028,387,1236,645,591,107Y09M
10013,10013010,10013010-060,2066,5810,2769,3041,107Y09M
10013,10013010,10013010-031,2251,6322,3194,3128,107Y09M
10013,10013010,10013010-041,958,2986,1559,1427,107Y09M
10013,10013010,10013010-015,183,463,232,231,107Y09M
10013,10013010,10013010-067,1079,2790,1363,1427,107Y09M
10013,10013010,10013010-030,3364,8584,4224,4360,107Y09M
10013,10013010,10013010-037,317,741,386,355,107Y09M
10013,10013010,10013010-038,566,1285,606,679,107Y09M
10013,10013010,10013010-006,105,261,138,123,107Y09M
10013,10013010,10013010-012,1187,3059,1551,1508,107Y09M
10013,10013010,10013010-071,809,2467,1220,1247,107Y09M
10013,10013010,10013010-017,143,312,163,149,107Y09M
10013,10013010,10013010-075,5377,13737,6546,7191,107Y09M
10013,10013010,10013010-034,428,949,508,441,107Y09M
10013,10013010,10013010-021,387,968,480,488,107Y09M
10013,10013010,10013010-020,710,1828,952,876,107Y09M
10013,10013010,10013010-061,351,872,391,481,107Y09M
10013,10013010,10013010-043,814,2640,1310,1330,107Y09M
10013,10013010,10013010-029,399,1282,669,613,107Y09M
10013,10013010,10013010-025,1773,4886,2360,2526,107Y09M
10013,10013010,10013010-024,1578,4459,2121,2338,107Y09M
10013,10013010,10013010-023,1195,2919,1397,1522,107Y09M
10013,10013010,10013010-048,121,316,171,145,107Y09M
10013,10013040,10013040-013,956,2694,1411,1283,107Y09M
10013,10013040,10013040-012,664,1891,1001,890,107Y09M
10013,10013040,10013040-004,1908,5011,2470,2541,107Y09M
10013,10013040,10013040-006,409,1068,541,527,107Y09M
10013,10013040,10013040-014,607,1627,885,742,107Y09M
10013,10013040,10013040-009,476,1215,672,543,107Y09M
10013,10013040,10013040-015,753,2031,1040,991,107Y09M
10013,10013040,10013040-002,1054,2752,1345,1407,107Y09M
10013,10013040,10013040-003,537,1363,682,681,107Y09M
10013,10013040,10013040-001,459,1079,550,529,107Y09M
10013,10013040,10013040-007,220,614,338,276,107Y09M
10013,10013040,10013040-005,1401,3719,1903,1816,107Y09M
10013,10013040,10013040-010,427,1120,559,561,107Y09M
10013,10013040,10013040-016,558,1439,734,705,107Y09M
10013,10013040,10013040-008,235,538,297,241,107Y09M
10013,10013040,10013040-011,487,1307,664,643,107Y09M
10013,10013040,10013040-017,512,1333,711,622,107Y09M
10013,10013310,10013310-004,319,1137,569,568,107Y09M
10013,10013310,10013310-006,155,598,309,289,107Y09M
10013,10013310,10013310-003,96,398,205,193,107Y09M
10013,10013310,10013310-002,237,814,417,397,107Y09M
10013,10013310,10013310-001,358,1158,608,550,107Y09M
10013,10013310,10013310-005,246,785,391,394,107Y09M
10013,10013180,10013180-004,453,1661,829,832,107Y09M
10013,10013180,10013180-006,554,1884,948,936,107Y09M
10013,10013180,10013180-005,379,1274,637,637,107Y09M
10013,10013180,10013180-001,860,2997,1514,1483,107Y09M
10013,10013180,10013180-003,445,1602,813,789,107Y09M
10013,10013180,10013180-008,676,2334,1213,1121,107Y09M
10013,10013180,10013180-007,340,1153,583,570,107Y09M
10013,10013180,10013180-002,790,2616,1291,1325,107Y09M
10013,10013290,10013290-003,169,744,377,367,107Y09M
10013,10013290,10013290-001,272,1076,552,524,107Y09M
10013,10013290,10013290-004,139,488,265,223,107Y09M
10013,10013290,10013290-002,308,1138,585,553,107Y09M
10013,10013290,10013290-005,225,930,505,425,107Y09M
10013,10013290,10013290-006,242,1006,533,473,107Y09M
10013,10013220,10013220-007,670,1911,1051,860,107Y09M
10013,10013220,10013220-004,649,1939,1055,884,107Y09M
10013,10013220,10013220-002,572,1448,782,666,107Y09M
10013,10013220,10013220-006,491,1270,695,575,107Y09M
10013,10013220,10013220-001,864,2382,1279,1103,107Y09M
10013,10013220,10013220-008,369,1004,561,443,107Y09M
10013,10013220,10013220-005,503,1328,734,594,107Y09M
10013,10013220,10013220-003,407,1114,634,480,107Y09M
10013,10013110,10013110-007,262,644,370,274,107Y09M
10013,10013110,10013110-009,274,713,393,320,107Y09M
10013,10013110,10013110-017,424,1219,632,587,107Y09M
10013,10013110,10013110-004,289,656,356,300,107Y09M
10013,10013110,10013110-003,358,825,426,399,107Y09M
10013,10013110,10013110-002,572,1432,742,690,107Y09M
10013,10013110,10013110-013,509,1423,742,681,107Y09M
10013,10013110,10013110-006,485,1326,743,583,107Y09M
10013,10013110,10013110-012,893,2089,1139,950,107Y09M
10013,10013110,10013110-001,990,2453,1309,1144,107Y09M
10013,10013110,10013110-008,302,867,478,389,107Y09M
10013,10013110,10013110-019,572,1697,887,810,107Y09M
10013,10013110,10013110-011,611,1630,843,787,107Y09M
10013,10013110,10013110-005,394,1151,593,558,107Y09M
10013,10013110,10013110-014,460,1177,634,543,107Y09M
10013,10013110,10013110-015,415,1279,690,589,107Y09M
10013,10013110,10013110-016,397,1163,634,529,107Y09M
10013,10013110,10013110-010,531,1370,717,653,107Y09M
10013,10013110,10013110-018,533,1352,720,632,107Y09M
10013,10013150,10013150-003,369,1048,539,509,107Y09M
10013,10013150,10013150-004,281,847,469,378,107Y09M
10013,10013150,10013150-002,396,1167,627,540,107Y09M
10013,10013150,10013150-001,879,2230,1148,1082,107Y09M
10013,10013150,10013150-005,667,1983,1061,922,107Y09M
10013,10013150,10013150-006,371,1264,681,583,107Y09M
10013,10013150,10013150-007,499,1504,807,697,107Y09M
10013,10013170,10013170-010,651,1782,894,888,107Y09M
10013,10013170,10013170-013,1160,3153,1667,1486,107Y09M
10013,10013170,10013170-005,324,965,491,474,107Y09M
10013,10013170,10013170-002,963,2915,1524,1391,107Y09M
10013,10013170,10013170-001,585,1913,1004,909,107Y09M
10013,10013170,10013170-003,716,2501,1305,1196,107Y09M
10013,10013170,10013170-015,965,2613,1319,1294,107Y09M
10013,10013170,10013170-011,557,1604,832,772,107Y09M
10013,10013170,10013170-008,449,1399,717,682,107Y09M
10013,10013170,10013170-012,815,2403,1269,1134,107Y09M
10013,10013170,10013170-004,326,999,513,486,107Y09M
10013,10013170,10013170-006,859,2642,1363,1279,107Y09M
10013,10013170,10013170-007,858,2659,1363,1296,107Y09M
10013,10013170,10013170-009,798,2451,1261,1190,107Y09M
10013,10013170,10013170-014,1803,4989,2592,2397,107Y09M
10013,10013320,10013320-002,301,931,482,449,107Y09M
10013,10013320,10013320-004,87,266,126,140,107Y09M
10013,10013320,10013320-007,222,731,397,334,107Y09M
10013,10013320,10013320-005,109,371,187,184,107Y09M
10013,10013320,10013320-008,129,407,212,195,107Y09M
10013,10013320,10013320-003,261,821,393,428,107Y09M
10013,10013320,10013320-001,288,896,460,436,107Y09M
10013,10013320,10013320-006,182,596,316,280,107Y09M
10013,10013050,10013050-014,255,941,460,481,107Y09M
10013,10013050,10013050-029,190,650,324,326,107Y09M
10013,10013050,10013050-021,580,2001,1028,973,107Y09M
10013,10013050,10013050-015,413,1478,783,695,107Y09M
10013,10013050,10013050-007,743,2408,1254,1154,107Y09M
10013,10013050,10013050-030,147,454,239,215,107Y09M
10013,10013050,10013050-010,327,1152,581,571,107Y09M
10013,10013050,10013050-008,556,1942,1034,908,107Y09M
10013,10013050,10013050-019,595,1889,1010,879,107Y09M
10013,10013050,10013050-016,496,1667,869,798,107Y09M
10013,10013050,10013050-020,591,1924,1038,886,107Y09M
10013,10013050,10013050-018,662,2266,1196,1070,107Y09M
10013,10013050,10013050-024,358,1213,643,570,107Y09M
10013,10013050,10013050-023,512,1776,925,851,107Y09M
10013,10013050,10013050-011,683,2175,1158,1017,107Y09M
10013,10013050,10013050-022,747,2431,1239,1192,107Y09M
10013,10013050,10013050-025,653,2326,1180,1146,107Y09M
10013,10013050,10013050-005,529,1615,827,788,107Y09M
10013,10013050,10013050-003,1283,3975,2016,1959,107Y09M
10013,10013050,10013050-001,223,704,361,343,107Y09M
10013,10013050,10013050-004,291,873,434,439,107Y09M
10013,10013050,10013050-002,341,1004,520,484,107Y09M
10013,10013050,10013050-009,778,2589,1356,1233,107Y09M
10013,10013050,10013050-017,344,1087,572,515,107Y09M
10013,10013050,10013050-027,368,1335,698,637,107Y09M
10013,10013050,10013050-028,277,949,467,482,107Y09M
10013,10013050,10013050-006,783,2654,1356,1298,107Y09M
10013,10013050,10013050-026,441,1651,886,765,107Y09M
10013,10013050,10013050-012,456,1813,946,867,107Y09M
10013,10013050,10013050-013,446,1649,879,770,107Y09M
10013,10013120,10013120-007,397,1215,659,556,107Y09M
10013,10013120,10013120-008,536,1626,895,731,107Y09M
10013,10013120,10013120-010,631,1907,1005,902,107Y09M
10013,10013120,10013120-011,542,1889,952,937,107Y09M
10013,10013120,10013120-012,480,1658,855,803,107Y09M
10013,10013120,10013120-006,424,1221,642,579,107Y09M
10013,10013120,10013120-005,200,631,330,301,107Y09M
10013,10013120,10013120-004,333,1050,536,514,107Y09M
10013,10013120,10013120-013,423,1471,762,709,107Y09M
10013,10013120,10013120-014,468,1343,711,632,107Y09M
10013,10013120,10013120-002,284,854,434,420,107Y09M
10013,10013120,10013120-003,642,1994,1010,984,107Y09M
10013,10013120,10013120-009,708,2349,1242,1107,107Y09M
10013,10013120,10013120-001,462,1382,693,689,107Y09M
10013,10013240,10013240-007,159,395,216,179,107Y09M
10013,10013240,10013240-003,571,1436,817,619,107Y09M
10013,10013240,10013240-002,187,463,243,220,107Y09M
10013,10013240,10013240-006,578,1519,799,720,107Y09M
10013,10013240,10013240-004,533,1458,765,693,107Y09M
10013,10013240,10013240-008,146,352,186,166,107Y09M
10013,10013240,10013240-001,645,1757,971,786,107Y09M
10013,10013240,10013240-005,233,687,361,326,107Y09M
10013,10013280,10013280-006,760,2391,1180,1211,107Y09M
10013,10013280,10013280-002,333,1004,515,489,107Y09M
10013,10013280,10013280-004,297,1088,548,540,107Y09M
10013,10013280,10013280-005,155,541,285,256,107Y09M
10013,10013280,10013280-001,180,541,268,273,107Y09M
10013,10013280,10013280-003,338,1270,655,615,107Y09M
10013,10013020,10013020-018,660,1851,986,865,107Y09M
10013,10013020,10013020-012,905,2615,1339,1276,107Y09M
10013,10013020,10013020-008,2795,7520,3672,3848,107Y09M
10013,10013020,10013020-009,920,2488,1204,1284,107Y09M
10013,10013020,10013020-007,2321,6267,3070,3197,107Y09M
10013,10013020,10013020-010,578,1641,812,829,107Y09M
10013,10013020,10013020-020,644,1967,1022,945,107Y09M
10013,10013020,10013020-013,3057,8305,4095,4210,107Y09M
10013,10013020,10013020-015,546,1617,818,799,107Y09M
10013,10013020,10013020-005,2115,5607,2749,2858,107Y09M
10013,10013020,10013020-002,257,661,330,331,107Y09M
10013,10013020,10013020-019,599,1888,968,920,107Y09M
10013,10013020,10013020-021,584,1757,936,821,107Y09M
10013,10013020,10013020-014,526,1411,704,707,107Y09M
10013,10013020,10013020-006,328,1042,531,511,107Y09M
10013,10013020,10013020-004,423,1089,550,539,107Y09M
10013,10013020,10013020-003,560,1398,706,692,107Y09M
10013,10013020,10013020-001,220,570,289,281,107Y09M
10013,10013020,10013020-011,951,2688,1348,1340,107Y09M
10013,10013020,10013020-016,342,1017,533,484,107Y09M
10013,10013020,10013020-017,186,547,289,258,107Y09M
10013,10013270,10013270-004,157,533,276,257,107Y09M
10013,10013270,10013270-003,54,217,116,101,107Y09M
10013,10013270,10013270-006,183,529,260,269,107Y09M
10013,10013270,10013270-005,131,426,215,211,107Y09M
10013,10013270,10013270-002,115,330,172,158,107Y09M
10013,10013270,10013270-001,422,1350,689,661,107Y09M
10013,10013070,10013070-005,435,1355,692,663,107Y09M
10013,10013070,10013070-006,317,926,484,442,107Y09M
10013,10013070,10013070-007,262,741,407,334,107Y09M
10013,10013070,10013070-001,800,2422,1245,1177,107Y09M
10013,10013070,10013070-004,1043,2900,1497,1403,107Y09M
10013,10013070,10013070-002,365,1057,539,518,107Y09M
10013,10013070,10013070-003,628,1694,879,815,107Y09M
10013,10013100,10013100-009,315,1039,559,480,107Y09M
10013,10013100,10013100-006,346,1200,632,568,107Y09M
10013,10013100,10013100-008,226,623,325,298,107Y09M
10013,10013100,10013100-010,626,1832,971,861,107Y09M
10013,10013100,10013100-007,674,2105,1123,982,107Y09M
10013,10013100,10013100-002,909,3270,1695,1575,107Y09M
10013,10013100,10013100-012,344,1110,586,524,107Y09M
10013,10013100,10013100-011,1252,4084,2090,1994,107Y09M
10013,10013100,10013100-001,1051,3644,1873,1771,107Y09M
10013,10013100,10013100-004,876,2720,1387,1333,107Y09M
10013,10013100,10013100-003,653,2161,1110,1051,107Y09M
10013,10013100,10013100-005,609,1982,1042,940,107Y09M
10005,10005130,10005130-005,599,1684,900,784,107Y09M
10005,10005130,10005130-004,1345,4041,2087,1954,107Y09M
10005,10005130,10005130-001,1570,4886,2560,2326,107Y09M
10005,10005130,10005130-006,170,466,252,214,107Y09M
10005,10005130,10005130-007,555,1434,796,638,107Y09M
10005,10005130,10005130-002,770,2183,1150,1033,107Y09M
10005,10005130,10005130-003,550,1590,858,732,107Y09M
10005,10005160,10005160-001,823,2592,1386,1206,107Y09M
10005,10005160,10005160-007,182,465,256,209,107Y09M
10005,10005160,10005160-006,255,616,347,269,107Y09M
10005,10005160,10005160-002,248,724,406,318,107Y09M
10005,10005160,10005160-005,230,609,341,268,107Y09M
10005,10005160,10005160-008,199,425,241,184,107Y09M
10005,10005160,10005160-004,109,259,139,120,107Y09M
10005,10005160,10005160-003,348,985,536,449,107Y09M
10005,10005080,10005080-005,270,617,356,261,107Y09M
10005,10005080,10005080-001,722,1885,963,922,107Y09M
10005,10005080,10005080-006,516,1423,757,666,107Y09M
10005,10005080,10005080-002,265,689,359,330,107Y09M
10005,10005080,10005080-009,309,866,493,373,107Y09M
10005,10005080,10005080-010,206,558,315,243,107Y09M
10005,10005080,10005080-007,275,735,401,334,107Y09M
10005,10005080,10005080-011,422,1167,629,538,107Y09M
10005,10005080,10005080-004,615,1593,818,775,107Y09M
10005,10005080,10005080-012,435,1161,639,522,107Y09M
10005,10005080,10005080-008,595,1787,945,842,107Y09M
10005,10005080,10005080-003,758,2065,1043,1022,107Y09M
10005,10005090,10005090-004,387,1077,584,493,107Y09M
10005,10005090,10005090-005,813,2685,1426,1259,107Y09M
10005,10005090,10005090-012,859,2616,1326,1290,107Y09M
10005,10005090,10005090-016,466,1484,815,669,107Y09M
10005,10005090,10005090-019,152,373,218,155,107Y09M
10005,10005090,10005090-013,570,1690,858,832,107Y09M
10005,10005090,10005090-006,891,2802,1424,1378,107Y09M
10005,10005090,10005090-007,500,1768,964,804,107Y09M
10005,10005090,10005090-017,558,1676,916,760,107Y09M
10005,10005090,10005090-018,105,244,136,108,107Y09M
10005,10005090,10005090-010,142,328,176,152,107Y09M
10005,10005090,10005090-009,739,2411,1264,1147,107Y09M
10005,10005090,10005090-008,412,1227,643,584,107Y09M
10005,10005090,10005090-011,167,383,221,162,107Y09M
10005,10005090,10005090-001,661,1901,935,966,107Y09M
10005,10005090,10005090-002,945,2933,1482,1451,107Y09M
10005,10005090,10005090-003,1274,4204,2151,2053,107Y09M
10005,10005090,10005090-015,510,1695,927,768,107Y09M
10005,10005090,10005090-014,599,1855,966,889,107Y09M
10005,10005040,10005040-005,2351,6665,3308,3357,107Y09M
10005,10005040,10005040-019,1894,4836,2504,2332,107Y09M
10005,10005040,10005040-010,2142,6044,3075,2969,107Y09M
10005,10005040,10005040-014,720,2388,1211,1177,107Y09M
10005,10005040,10005040-013,546,1718,892,826,107Y09M
10005,10005040,10005040-011,460,1315,696,619,107Y09M
10005,10005040,10005040-012,1162,3431,1738,1693,107Y09M
10005,10005040,10005040-022,396,1196,662,534,107Y09M
10005,10005040,10005040-018,429,1373,731,642,107Y09M
10005,10005040,10005040-024,929,2838,1390,1448,107Y09M
10005,10005040,10005040-003,1360,3387,1716,1671,107Y09M
10005,10005040,10005040-001,928,2288,1084,1204,107Y09M
10005,10005040,10005040-008,1373,3908,1988,1920,107Y09M
10005,10005040,10005040-023,1354,4319,2150,2169,107Y09M
10005,10005040,10005040-016,1642,4990,2539,2451,107Y09M
10005,10005040,10005040-021,1576,4330,2272,2058,107Y09M
10005,10005040,10005040-020,823,2482,1279,1203,107Y09M
10005,10005040,10005040-017,775,2626,1336,1290,107Y09M
10005,10005040,10005040-015,484,1261,622,639,107Y09M
10005,10005040,10005040-004,2215,5818,2847,2971,107Y09M
10005,10005040,10005040-002,1575,4466,2190,2276,107Y09M
10005,10005040,10005040-007,1427,4635,2316,2319,107Y09M
10005,10005040,10005040-025,922,2796,1409,1387,107Y09M
10005,10005040,10005040-009,842,2575,1311,1264,107Y09M
10005,10005040,10005040-006,1474,4344,2191,2153,107Y09M
10005,10005140,10005140-009,246,758,441,317,107Y09M
10005,10005140,10005140-007,409,1028,579,449,107Y09M
10005,10005140,10005140-002,231,617,347,270,107Y09M
10005,10005140,10005140-003,357,923,504,419,107Y09M
10005,10005140,10005140-004,247,720,404,316,107Y09M
10005,10005140,10005140-005,224,568,321,247,107Y09M
10005,10005140,10005140-001,237,675,374,301,107Y09M
10005,10005140,10005140-008,452,1301,717,584,107Y09M
10005,10005140,10005140-006,232,499,271,228,107Y09M
10005,10005070,10005070-003,850,2398,1239,1159,107Y09M
10005,10005070,10005070-001,356,838,427,411,107Y09M
10005,10005070,10005070-009,876,2481,1321,1160,107Y09M
10005,10005070,10005070-007,848,2234,1151,1083,107Y09M
10005,10005070,10005070-005,317,858,450,408,107Y09M
10005,10005070,10005070-011,605,1965,1038,927,107Y09M
10005,10005070,10005070-010,296,806,448,358,107Y09M
10005,10005070,10005070-006,342,1137,572,565,107Y09M
10005,10005070,10005070-002,661,1729,907,822,107Y09M
10005,10005070,10005070-008,473,1257,656,601,107Y09M
10005,10005070,10005070-004,395,1130,611,519,107Y09M
10005,10005110,10005110-004,382,919,510,409,107Y09M
10005,10005110,10005110-002,296,733,387,346,107Y09M
10005,10005110,10005110-001,536,1301,727,574,107Y09M
10005,10005110,10005110-009,449,1145,646,499,107Y09M
10005,10005110,10005110-003,593,1643,884,759,107Y09M
10005,10005110,10005110-006,486,1220,653,567,107Y09M
10005,10005110,10005110-007,404,1203,651,552,107Y09M
10005,10005110,10005110-005,394,947,530,417,107Y09M
10005,10005110,10005110-008,401,1016,565,451,107Y09M
10005,10005060,10005060-012,595,1754,934,820,107Y09M
10005,10005060,10005060-004,1602,5231,2711,2520,107Y09M
10005,10005060,10005060-022,491,1184,662,522,107Y09M
10005,10005060,10005060-002,300,956,495,461,107Y09M
10005,10005060,10005060-018,388,1176,622,554,107Y09M
10005,10005060,10005060-003,522,1596,804,792,107Y09M
10005,10005060,10005060-015,422,1180,664,516,107Y09M
10005,10005060,10005060-017,261,818,426,392,107Y09M
10005,10005060,10005060-011,583,1719,915,804,107Y09M
10005,10005060,10005060-023,496,1373,771,602,107Y09M
10005,10005060,10005060-001,591,1780,924,856,107Y09M
10005,10005060,10005060-008,977,3319,1754,1565,107Y09M
10005,10005060,10005060-007,408,1172,599,573,107Y09M
10005,10005060,10005060-016,377,1034,561,473,107Y09M
10005,10005060,10005060-014,389,1110,613,497,107Y09M
10005,10005060,10005060-010,269,810,432,378,107Y09M
10005,10005060,10005060-009,480,1631,809,822,107Y09M
10005,10005060,10005060-005,822,2688,1379,1309,107Y09M
10005,10005060,10005060-021,283,825,464,361,107Y09M
10005,10005060,10005060-020,516,1436,785,651,107Y09M
10005,10005060,10005060-019,239,691,373,318,107Y09M
10005,10005060,10005060-006,465,1421,743,678,107Y09M
10005,10005060,10005060-013,493,1449,821,628,107Y09M
10005,10005010,10005010-015,772,1920,955,965,107Y09M
10005,10005010,10005010-011,262,589,291,298,107Y09M
10005,10005010,10005010-001,534,1357,669,688,107Y09M
10005,10005010,10005010-021,1531,4602,2300,2302,107Y09M
10005,10005010,10005010-028,1378,4310,2207,2103,107Y09M
10005,10005010,10005010-023,1128,2894,1404,1490,107Y09M
10005,10005010,10005010-016,2260,6184,3023,3161,107Y09M
10005,10005010,10005010-010,403,1044,521,523,107Y09M
10005,10005010,10005010-004,957,2666,1338,1328,107Y09M
10005,10005010,10005010-005,1476,4436,2229,2207,107Y09M
10005,10005010,10005010-003,475,1176,570,606,107Y09M
10005,10005010,10005010-027,797,2283,1200,1083,107Y09M
10005,10005010,10005010-002,1868,4996,2402,2594,107Y09M
10005,10005010,10005010-014,637,1628,791,837,107Y09M
10005,10005010,10005010-009,1335,3710,1883,1827,107Y09M
10005,10005010,10005010-017,1422,3682,1769,1913,107Y09M
10005,10005010,10005010-013,1584,4495,2273,2222,107Y09M
10005,10005010,10005010-020,520,1374,744,630,107Y09M
10005,10005010,10005010-012,370,968,483,485,107Y09M
10005,10005010,10005010-024,697,1966,1027,939,107Y09M
10005,10005010,10005010-018,1355,4119,2062,2057,107Y09M
10005,10005010,10005010-026,1093,3380,1713,1667,107Y09M
10005,10005010,10005010-025,1416,4076,2023,2053,107Y09M
10005,10005010,10005010-019,1742,4965,2436,2529,107Y09M
10005,10005010,10005010-022,2328,6305,3119,3186,107Y09M
10005,10005010,10005010-008,413,992,514,478,107Y09M
10005,10005010,10005010-007,1352,3900,1918,1982,107Y09M
10005,10005010,10005010-006,1410,4323,2201,2122,107Y09M
10005,10005020,10005020-021,575,1855,1008,847,107Y09M
10005,10005020,10005020-024,522,1708,911,797,107Y09M
10005,10005020,10005020-014,539,1573,829,744,107Y09M
10005,10005020,10005020-010,776,2516,1302,1214,107Y09M
10005,10005020,10005020-012,242,739,395,344,107Y09M
10005,10005020,10005020-022,640,2043,1069,974,107Y09M
10005,10005020,10005020-025,681,2193,1147,1046,107Y09M
10005,10005020,10005020-017,203,611,331,280,107Y09M
10005,10005020,10005020-004,552,1821,919,902,107Y09M
10005,10005020,10005020-006,773,2345,1189,1156,107Y09M
10005,10005020,10005020-008,835,2652,1395,1257,107Y09M
10005,10005020,10005020-019,829,2728,1430,1298,107Y09M
10005,10005020,10005020-023,289,792,447,345,107Y09M
10005,10005020,10005020-009,1608,4744,2395,2349,107Y09M
10005,10005020,10005020-003,373,1009,525,484,107Y09M
10005,10005020,10005020-011,350,1039,561,478,107Y09M
10005,10005020,10005020-001,875,2641,1321,1320,107Y09M
10005,10005020,10005020-002,657,1853,912,941,107Y09M
10005,10005020,10005020-005,438,1456,760,696,107Y09M
10005,10005020,10005020-020,604,1875,1022,853,107Y09M
10005,10005020,10005020-007,407,1228,653,575,107Y09M
10005,10005020,10005020-013,490,1546,793,753,107Y09M
10005,10005020,10005020-016,428,1435,768,667,107Y09M
10005,10005020,10005020-018,334,924,527,397,107Y09M
10005,10005020,10005020-015,686,2094,1065,1029,107Y09M
10005,10005180,10005180-001,119,393,220,173,107Y09M
10005,10005180,10005180-008,215,710,358,352,107Y09M
10005,10005180,10005180-004,203,563,298,265,107Y09M
10005,10005180,10005180-005,195,659,335,324,107Y09M
10005,10005180,10005180-006,190,650,332,318,107Y09M
10005,10005180,10005180-003,369,994,551,443,107Y09M
10005,10005180,10005180-007,271,790,423,367,107Y09M
10005,10005180,10005180-002,421,1324,723,601,107Y09M
10005,10005030,10005030-013,506,1663,887,776,107Y09M
10005,10005030,10005030-012,501,1505,798,707,107Y09M
10005,10005030,10005030-021,285,872,486,386,107Y09M
10005,10005030,10005030-014,658,2145,1150,995,107Y09M
10005,10005030,10005030-003,700,2205,1141,1064,107Y09M
10005,10005030,10005030-024,786,2425,1215,1210,107Y09M
10005,10005030,10005030-023,294,829,456,373,107Y09M
10005,10005030,10005030-022,532,1631,829,802,107Y09M
10005,10005030,10005030-005,265,797,446,351,107Y09M
10005,10005030,10005030-011,457,1371,730,641,107Y09M
10005,10005030,10005030-009,338,872,485,387,107Y09M
10005,10005030,10005030-007,280,762,401,361,107Y09M
10005,10005030,10005030-008,403,1033,593,440,107Y09M
10005,10005030,10005030-016,414,1045,552,493,107Y09M
10005,10005030,10005030-004,564,1786,950,836,107Y09M
10005,10005030,10005030-002,834,2228,1115,1113,107Y09M
10005,10005030,10005030-001,486,1280,633,647,107Y09M
10005,10005030,10005030-006,988,3160,1650,1510,107Y09M
10005,10005030,10005030-019,818,2603,1377,1226,107Y09M
10005,10005030,10005030-020,421,1325,730,595,107Y09M
10005,10005030,10005030-015,216,507,287,220,107Y09M
10005,10005030,10005030-018,305,924,501,423,107Y09M
10005,10005030,10005030-010,330,744,401,343,107Y09M
10005,10005030,10005030-017,202,436,254,182,107Y09M
10005,10005150,10005150-004,1206,4045,2095,1950,107Y09M
10005,10005150,10005150-006,173,576,328,248,107Y09M
10005,10005150,10005150-002,187,533,289,244,107Y09M
10005,10005150,10005150-001,842,2390,1240,1150,107Y09M
10005,10005150,10005150-007,461,1465,750,715,107Y09M
10005,10005150,10005150-008,312,884,469,415,107Y09M
10005,10005150,10005150-005,195,585,310,275,107Y09M
10005,10005150,10005150-009,373,1087,614,473,107Y09M
10005,10005150,10005150-003,389,1175,629,546,107Y09M
10005,10005170,10005170-002,240,628,349,279,107Y09M
10005,10005170,10005170-001,151,361,223,138,107Y09M
10005,10005170,10005170-007,291,739,403,336,107Y09M
10005,10005170,10005170-004,232,641,355,286,107Y09M
10005,10005170,10005170-003,401,1003,558,445,107Y09M
10005,10005170,10005170-006,148,358,194,164,107Y09M
10005,10005170,10005170-005,250,648,365,283,107Y09M
10005,10005100,10005100-005,425,1413,781,632,107Y09M
10005,10005100,10005100-007,1230,3660,1947,1713,107Y09M
10005,10005100,10005100-006,441,1236,682,554,107Y09M
10005,10005100,10005100-009,205,481,285,196,107Y09M
10005,10005100,10005100-003,685,1929,1014,915,107Y09M
10005,10005100,10005100-010,260,620,348,272,107Y09M
10005,10005100,10005100-001,415,1206,612,594,107Y09M
10005,10005100,10005100-002,1763,5251,2718,2533,107Y09M
10005,10005100,10005100-004,479,1486,803,683,107Y09M
10005,10005100,10005100-008,255,669,369,300,107Y09M
10005,10005050,10005050-021,972,3062,1592,1470,107Y09M
10005,10005050,10005050-006,998,3114,1616,1498,107Y09M
10005,10005050,10005050-020,888,2386,1253,1133,107Y09M
10005,10005050,10005050-007,397,1149,606,543,107Y09M
10005,10005050,10005050-016,1544,4885,2454,2431,107Y09M
10005,10005050,10005050-033,1247,3480,1713,1767,107Y09M
10005,10005050,10005050-010,694,1854,930,924,107Y09M
10005,10005050,10005050-032,1533,4400,2157,2243,107Y09M
10005,10005050,10005050-003,1152,3553,1828,1725,107Y09M
10005,10005050,10005050-027,932,2782,1409,1373,107Y09M
10005,10005050,10005050-013,934,2347,1151,1196,107Y09M
10005,10005050,10005050-026,877,2427,1236,1191,107Y09M
10005,10005050,10005050-018,1779,4787,2396,2391,107Y09M
10005,10005050,10005050-031,1086,3243,1652,1591,107Y09M
10005,10005050,10005050-023,931,3055,1616,1439,107Y09M
10005,10005050,10005050-022,482,1566,805,761,107Y09M
10005,10005050,10005050-029,1483,4682,2256,2426,107Y09M
10005,10005050,10005050-030,966,2510,1206,1304,107Y09M
10005,10005050,10005050-012,433,1232,619,613,107Y09M
10005,10005050,10005050-009,1355,4022,1938,2084,107Y09M
10005,10005050,10005050-014,1596,4207,2108,2099,107Y09M
10005,10005050,10005050-011,507,1093,583,510,107Y09M
10005,10005050,10005050-028,1428,4585,2257,2328,107Y09M
10005,10005050,10005050-015,1749,4959,2490,2469,107Y09M
10005,10005050,10005050-001,790,2601,1394,1207,107Y09M
10005,10005050,10005050-002,677,2033,1071,962,107Y09M
10005,10005050,10005050-004,1324,4414,2290,2124,107Y09M
10005,10005050,10005050-024,331,1048,557,491,107Y09M
10005,10005050,10005050-005,1832,5223,2690,2533,107Y09M
10005,10005050,10005050-008,1416,4032,1926,2106,107Y09M
10005,10005050,10005050-025,780,2553,1343,1210,107Y09M
10005,10005050,10005050-017,1584,4148,1990,2158,107Y09M
10005,10005050,10005050-019,513,1580,844,736,107Y09M
10005,10005120,10005120-003,283,842,430,412,107Y09M
10005,10005120,10005120-005,328,1019,553,466,107Y09M
10005,10005120,10005120-007,425,1105,605,500,107Y09M
10005,10005120,10005120-006,193,416,230,186,107Y09M
10005,10005120,10005120-002,685,2104,1103,1001,107Y09M
10005,10005120,10005120-004,607,1990,1073,917,107Y09M
10005,10005120,10005120-008,147,344,193,151,107Y09M
10005,10005120,10005120-001,980,2905,1492,1413,107Y09M
68000,68000080,68000080-036,929,2730,1294,1436,107Y09M
68000,68000080,68000080-026,1650,5113,2536,2577,107Y09M
68000,68000080,68000080-030,1847,5049,2440,2609,107Y09M
68000,68000080,68000080-018,648,1820,892,928,107Y09M
68000,68000080,68000080-015,1300,4102,2070,2032,107Y09M
68000,68000080,68000080-019,1300,3974,2001,1973,107Y09M
68000,68000080,68000080-034,550,1801,916,885,107Y09M
68000,68000080,68000080-042,1752,4843,2445,2398,107Y09M
68000,68000080,68000080-017,3364,8711,4220,4491,107Y09M
68000,68000080,68000080-021,855,2342,1165,1177,107Y09M
68000,68000080,68000080-029,1154,3427,1694,1733,107Y09M
68000,68000080,68000080-033,1499,4341,2160,2181,107Y09M
68000,68000080,68000080-024,1276,4166,2402,1764,107Y09M
68000,68000080,68000080-023,1775,4886,2379,2507,107Y09M
68000,68000080,68000080-031,1137,3689,1890,1799,107Y09M
68000,68000080,68000080-027,2045,4825,2298,2527,107Y09M
68000,68000080,68000080-032,783,2372,1228,1144,107Y09M
68000,68000080,68000080-025,1042,3072,1584,1488,107Y09M
68000,68000080,68000080-048,1021,3184,1643,1541,107Y09M
68000,68000080,68000080-014,1621,4579,2344,2235,107Y09M
68000,68000080,68000080-041,1083,3150,1545,1605,107Y09M
68000,68000080,68000080-020,1632,4536,2210,2326,107Y09M
68000,68000080,68000080-037,838,2371,1174,1197,107Y09M
68000,68000080,68000080-043,1717,4747,2257,2490,107Y09M
68000,68000080,68000080-022,2346,6409,3116,3293,107Y09M
68000,68000080,68000080-035,634,1704,857,847,107Y09M
68000,68000080,68000080-016,1480,4539,2262,2277,107Y09M
68000,68000080,68000080-047,1070,3426,1736,1690,107Y09M
68000,68000080,68000080-013,1205,3796,1972,1824,107Y09M
68000,68000080,68000080-009,1339,4046,2095,1951,107Y09M
68000,68000080,68000080-038,2253,5455,2632,2823,107Y09M
68000,68000080,68000080-011,983,3098,1563,1535,107Y09M
68000,68000080,68000080-012,1636,4617,2298,2319,107Y09M
68000,68000080,68000080-039,1373,3745,1860,1885,107Y09M
68000,68000080,68000080-046,2056,5248,2561,2687,107Y09M
68000,68000080,68000080-028,1751,5063,2522,2541,107Y09M
68000,68000080,68000080-006,1367,3936,2011,1925,107Y09M
68000,68000080,68000080-004,1309,3853,1901,1952,107Y09M
68000,68000080,68000080-005,1526,4247,2073,2174,107Y09M
68000,68000080,68000080-040,1056,3191,1606,1585,107Y09M
68000,68000080,68000080-003,1837,4504,2243,2261,107Y09M
68000,68000080,68000080-002,4202,10253,5121,5132,107Y09M
68000,68000080,68000080-008,1897,5375,2673,2702,107Y09M
68000,68000080,68000080-044,1050,3139,1612,1527,107Y09M
68000,68000080,68000080-007,1237,3871,1996,1875,107Y09M
68000,68000080,68000080-010,863,2545,1335,1210,107Y09M
68000,68000080,68000080-001,3782,8673,4435,4238,107Y09M
68000,68000080,68000080-045,883,2621,1295,1326,107Y09M
68000,68000060,68000060-011,3194,8409,4202,4207,107Y09M
68000,68000060,68000060-010,1151,3547,1804,1743,107Y09M
68000,68000060,68000060-008,758,1927,984,943,107Y09M
68000,68000060,68000060-001,2758,7593,3852,3741,107Y09M
68000,68000060,68000060-006,1950,5870,3081,2789,107Y09M
68000,68000060,68000060-017,932,2617,1380,1237,107Y09M
68000,68000060,68000060-018,1155,3179,1632,1547,107Y09M
68000,68000060,68000060-002,2896,8143,4127,4016,107Y09M
68000,68000060,68000060-016,1087,3066,1576,1490,107Y09M
68000,68000060,68000060-012,1473,3867,1968,1899,107Y09M
68000,68000060,68000060-014,1283,3203,1722,1481,107Y09M
68000,68000060,68000060-004,614,1892,1003,889,107Y09M
68000,68000060,68000060-019,2627,6492,3246,3246,107Y09M
68000,68000060,68000060-015,1039,2957,1505,1452,107Y09M
68000,68000060,68000060-007,2555,7127,3695,3432,107Y09M
68000,68000060,68000060-013,841,2225,1183,1042,107Y09M
68000,68000060,68000060-003,1919,5561,2889,2672,107Y09M
68000,68000060,68000060-005,5149,12566,6224,6342,107Y09M
68000,68000030,68000030-003,2119,5741,2905,2836,107Y09M
68000,68000030,68000030-004,2320,6731,3328,3403,107Y09M
68000,68000030,68000030-024,1165,3383,1649,1734,107Y09M
68000,68000030,68000030-014,615,1775,973,802,107Y09M
68000,68000030,68000030-026,1725,4765,2382,2383,107Y09M
68000,68000030,68000030-027,1947,6183,3090,3093,107Y09M
68000,68000030,68000030-019,1290,3799,1905,1894,107Y09M
68000,68000030,68000030-028,1368,4000,2022,1978,107Y09M
68000,68000030,68000030-017,1529,4536,2281,2255,107Y09M
68000,68000030,68000030-018,2052,6342,3221,3121,107Y09M
68000,68000030,68000030-015,1352,3455,1619,1836,107Y09M
68000,68000030,68000030-005,465,1489,787,702,107Y09M
68000,68000030,68000030-006,458,1092,603,489,107Y09M
68000,68000030,68000030-025,1776,5443,2736,2707,107Y09M
68000,68000030,68000030-023,1009,2859,1401,1458,107Y09M
68000,68000030,68000030-021,1946,5938,3195,2743,107Y09M
68000,68000030,68000030-007,1247,3524,1879,1645,107Y09M
68000,68000030,68000030-020,598,1898,946,952,107Y09M
68000,68000030,68000030-011,539,1562,821,741,107Y09M
68000,68000030,68000030-009,403,1055,595,460,107Y09M
68000,68000030,68000030-010,394,938,514,424,107Y09M
68000,68000030,68000030-022,1471,4507,2326,2181,107Y09M
68000,68000030,68000030-013,1002,3200,1710,1490,107Y09M
68000,68000030,68000030-012,718,2053,1090,963,107Y09M
68000,68000030,68000030-016,1246,3067,1455,1612,107Y09M
68000,68000030,68000030-002,389,1198,638,560,107Y09M
68000,68000030,68000030-008,965,2595,1360,1235,107Y09M
68000,68000030,68000030-001,647,1747,875,872,107Y09M
68000,68000020,68000020-048,1176,3799,1979,1820,107Y09M
68000,68000020,68000020-049,1467,4400,2361,2039,107Y09M
68000,68000020,68000020-068,2167,5644,2749,2895,107Y09M
68000,68000020,68000020-015,1659,4122,2028,2094,107Y09M
68000,68000020,68000020-019,2181,5931,2941,2990,107Y09M
68000,68000020,68000020-040,491,1253,621,632,107Y09M
68000,68000020,68000020-026,1597,4446,2181,2265,107Y09M
68000,68000020,68000020-010,1756,4779,2300,2479,107Y09M
68000,68000020,68000020-050,422,1127,554,573,107Y09M
68000,68000020,68000020-081,1503,3930,1859,2071,107Y09M
68000,68000020,68000020-028,317,877,464,413,107Y09M
68000,68000020,68000020-064,1560,4291,2120,2171,107Y09M
68000,68000020,68000020-044,2649,7515,3773,3742,107Y09M
68000,68000020,68000020-075,1652,4450,2202,2248,107Y09M
68000,68000020,68000020-012,2469,6745,3274,3471,107Y09M
68000,68000020,68000020-030,1206,3380,1697,1683,107Y09M
68000,68000020,68000020-013,1274,3537,1830,1707,107Y09M
68000,68000020,68000020-070,1795,4608,2251,2357,107Y09M
68000,68000020,68000020-072,2077,5567,2682,2885,107Y09M
68000,68000020,68000020-003,1451,3722,1822,1900,107Y09M
68000,68000020,68000020-027,2429,8369,4254,4115,107Y09M
68000,68000020,68000020-051,1885,5561,2839,2722,107Y09M
68000,68000020,68000020-005,899,2552,1296,1256,107Y09M
68000,68000020,68000020-034,3340,10977,5312,5665,107Y09M
68000,68000020,68000020-047,2158,6306,3210,3096,107Y09M
68000,68000020,68000020-031,1491,4104,2122,1982,107Y09M
68000,68000020,68000020-066,1849,5329,2621,2708,107Y09M
68000,68000020,68000020-055,2595,6680,3255,3425,107Y09M
68000,68000020,68000020-074,2385,6504,3257,3247,107Y09M
68000,68000020,68000020-004,445,1082,538,544,107Y09M
68000,68000020,68000020-038,882,2061,1037,1024,107Y09M
68000,68000020,68000020-007,2511,6549,3172,3377,107Y09M
68000,68000020,68000020-006,1583,5276,2611,2665,107Y09M
68000,68000020,68000020-008,2521,6013,2893,3120,107Y09M
68000,68000020,68000020-078,1625,4007,1906,2101,107Y09M
68000,68000020,68000020-083,2671,6543,3162,3381,107Y09M
68000,68000020,68000020-009,1551,4183,2003,2180,107Y09M
68000,68000020,68000020-063,1665,4372,2155,2217,107Y09M
68000,68000020,68000020-059,952,3253,1598,1655,107Y09M
68000,68000020,68000020-073,2700,7120,3424,3696,107Y09M
68000,68000020,68000020-057,2072,5843,2851,2992,107Y09M
68000,68000020,68000020-018,1843,4451,2141,2310,107Y09M
68000,68000020,68000020-036,3319,8865,4374,4491,107Y09M
68000,68000020,68000020-062,2077,5928,2929,2999,107Y09M
68000,68000020,68000020-021,1672,4066,1953,2113,107Y09M
68000,68000020,68000020-084,1769,4849,2340,2509,107Y09M
68000,68000020,68000020-046,1553,3963,2068,1895,107Y09M
68000,68000020,68000020-085,2127,4911,2236,2675,107Y09M
68000,68000020,68000020-032,2006,4372,2144,2228,107Y09M
68000,68000020,68000020-037,1955,5604,2722,2882,107Y09M
68000,68000020,68000020-042,2188,5802,2861,2941,107Y09M
68000,68000020,68000020-022,2833,6110,3085,3025,107Y09M
68000,68000020,68000020-052,2018,5632,2761,2871,107Y09M
68000,68000020,68000020-079,2035,5850,2784,3066,107Y09M
68000,68000020,68000020-077,1588,4057,1946,2111,107Y09M
68000,68000020,68000020-056,2406,6803,3296,3507,107Y09M
68000,68000020,68000020-033,4387,12270,5914,6356,107Y09M
68000,68000020,68000020-016,2253,5573,2736,2837,107Y09M
68000,68000020,68000020-060,1674,4464,2188,2276,107Y09M
68000,68000020,68000020-061,1637,4512,2195,2317,107Y09M
68000,68000020,68000020-017,3444,6606,3579,3027,107Y09M
68000,68000020,68000020-053,1024,3273,1617,1656,107Y09M
68000,68000020,68000020-071,1634,4289,2104,2185,107Y09M
68000,68000020,68000020-076,1505,4291,2076,2215,107Y09M
68000,68000020,68000020-024,1681,4472,2186,2286,107Y09M
68000,68000020,68000020-014,1043,2356,1144,1212,107Y09M
68000,68000020,68000020-025,1665,4603,2219,2384,107Y09M
68000,68000020,68000020-043,3198,8235,4052,4183,107Y09M
68000,68000020,68000020-058,1224,3403,1698,1705,107Y09M
68000,68000020,68000020-069,1201,3075,1506,1569,107Y09M
68000,68000020,68000020-023,1237,3103,1547,1556,107Y09M
68000,68000020,68000020-020,1647,4124,1998,2126,107Y09M
68000,68000020,68000020-080,1003,2966,1502,1464,107Y09M
68000,68000020,68000020-054,1140,3363,1689,1674,107Y09M
68000,68000020,68000020-041,1714,3554,1631,1923,107Y09M
68000,68000020,68000020-035,874,2328,1126,1202,107Y09M
68000,68000020,68000020-001,1316,3561,1697,1864,107Y09M
68000,68000020,68000020-067,875,2566,1240,1326,107Y09M
68000,68000020,68000020-029,1862,5686,2869,2817,107Y09M
68000,68000020,68000020-002,2244,6414,3184,3230,107Y09M
68000,68000020,68000020-039,2130,5964,2892,3072,107Y09M
68000,68000020,68000020-082,2314,5735,2734,3001,107Y09M
68000,68000020,68000020-065,1792,4870,2436,2434,107Y09M
68000,68000020,68000020-011,1955,5141,2559,2582,107Y09M
68000,68000020,68000020-045,650,1809,952,857,107Y09M
68000,68000100,68000100-015,918,2773,1386,1387,107Y09M
68000,68000100,68000100-022,762,2072,1001,1071,107Y09M
68000,68000100,68000100-040,692,1902,946,956,107Y09M
68000,68000100,68000100-036,1453,4525,2271,2254,107Y09M
68000,68000100,68000100-041,1584,4591,2231,2360,107Y09M
68000,68000100,68000100-011,1563,4900,2496,2404,107Y09M
68000,68000100,68000100-009,1013,2917,1468,1449,107Y09M
68000,68000100,68000100-010,1476,4925,2456,2469,107Y09M
68000,68000100,68000100-045,2028,5868,2985,2883,107Y09M
68000,68000100,68000100-046,2761,8221,4128,4093,107Y09M
68000,68000100,68000100-043,2563,6987,3305,3682,107Y09M
68000,68000100,68000100-012,1693,5316,2678,2638,107Y09M
68000,68000100,68000100-006,1550,4706,2333,2373,107Y09M
68000,68000100,68000100-021,629,1389,673,716,107Y09M
68000,68000100,68000100-025,1144,3354,1632,1722,107Y09M
68000,68000100,68000100-018,1365,3970,1977,1993,107Y09M
68000,68000100,68000100-024,2113,6435,3362,3073,107Y09M
68000,68000100,68000100-033,2812,7825,3846,3979,107Y09M
68000,68000100,68000100-039,1295,3541,1698,1843,107Y09M
68000,68000100,68000100-013,2334,7090,3572,3518,107Y09M
68000,68000100,68000100-023,1533,4980,2551,2429,107Y09M
68000,68000100,68000100-002,1663,5136,2621,2515,107Y09M
68000,68000100,68000100-014,1911,5351,2624,2727,107Y09M
68000,68000100,68000100-003,2344,6834,3217,3617,107Y09M
68000,68000100,68000100-042,2057,6424,3112,3312,107Y09M
68000,68000100,68000100-016,2109,6451,3165,3286,107Y09M
68000,68000100,68000100-030,1822,5446,2747,2699,107Y09M
68000,68000100,68000100-029,746,2161,1087,1074,107Y09M
68000,68000100,68000100-038,1772,5238,2606,2632,107Y09M
68000,68000100,68000100-020,900,2554,1288,1266,107Y09M
68000,68000100,68000100-026,1778,5273,2621,2652,107Y09M
68000,68000100,68000100-044,1766,4404,2146,2258,107Y09M
68000,68000100,68000100-008,3457,7630,3939,3691,107Y09M
68000,68000100,68000100-035,1206,3700,1875,1825,107Y09M
68000,68000100,68000100-007,1550,4385,2208,2177,107Y09M
68000,68000100,68000100-037,2046,5982,2911,3071,107Y09M
68000,68000100,68000100-005,2332,6271,3030,3241,107Y09M
68000,68000100,68000100-028,2723,7966,3947,4019,107Y09M
68000,68000100,68000100-032,1305,3927,1999,1928,107Y09M
68000,68000100,68000100-034,1750,5135,2529,2606,107Y09M
68000,68000100,68000100-031,1620,4569,2224,2345,107Y09M
68000,68000100,68000100-004,2466,6719,3188,3531,107Y09M
68000,68000100,68000100-017,1241,3345,1632,1713,107Y09M
68000,68000100,68000100-019,1077,3192,1537,1655,107Y09M
68000,68000100,68000100-027,1223,3543,1881,1662,107Y09M
68000,68000100,68000100-001,1937,5791,2952,2839,107Y09M
68000,68000010,68000010-076,1624,4262,2104,2158,107Y09M
68000,68000010,68000010-045,1966,5273,2540,2733,107Y09M
68000,68000010,68000010-057,3032,7478,3565,3913,107Y09M
68000,68000010,68000010-004,3163,8705,4261,4444,107Y09M
68000,68000010,68000010-078,2360,6220,2989,3231,107Y09M
68000,68000010,68000010-077,1606,4878,2404,2474,107Y09M
68000,68000010,68000010-046,2572,6428,3158,3270,107Y09M
68000,68000010,68000010-043,2157,6103,2956,3147,107Y09M
68000,68000010,68000010-023,3039,8238,3930,4308,107Y09M
68000,68000010,68000010-064,2233,5528,2692,2836,107Y09M
68000,68000010,68000010-030,2496,6170,3004,3166,107Y09M
68000,68000010,68000010-029,1872,5254,2617,2637,107Y09M
68000,68000010,68000010-020,656,1568,794,774,107Y09M
68000,68000010,68000010-062,2681,6949,3366,3583,107Y09M
68000,68000010,68000010-065,2028,5643,2689,2954,107Y09M
68000,68000010,68000010-017,808,2641,1375,1266,107Y09M
68000,68000010,68000010-066,1846,5117,2430,2687,107Y09M
68000,68000010,68000010-070,2681,6691,3098,3593,107Y09M
68000,68000010,68000010-054,1815,4695,2236,2459,107Y09M
68000,68000010,68000010-049,3123,7658,3616,4042,107Y09M
68000,68000010,68000010-055,2774,8151,4071,4080,107Y09M
68000,68000010,68000010-040,2266,6599,3237,3362,107Y09M
68000,68000010,68000010-052,1154,3101,1567,1534,107Y09M
68000,68000010,68000010-001,402,805,363,442,107Y09M
68000,68000010,68000010-021,396,1006,507,499,107Y09M
68000,68000010,68000010-002,610,1601,759,842,107Y09M
68000,68000010,68000010-031,807,1962,957,1005,107Y09M
68000,68000010,68000010-069,2151,5768,2755,3013,107Y09M
68000,68000010,68000010-008,716,1698,829,869,107Y09M
68000,68000010,68000010-011,2046,5575,2769,2806,107Y09M
68000,68000010,68000010-009,811,1966,981,985,107Y09M
68000,68000010,68000010-028,2127,5937,2915,3022,107Y09M
68000,68000010,68000010-034,2162,6107,2964,3143,107Y09M
68000,68000010,68000010-050,4107,10384,4990,5394,107Y09M
68000,68000010,68000010-072,2929,7920,3815,4105,107Y09M
68000,68000010,68000010-037,1736,4666,2245,2421,107Y09M
68000,68000010,68000010-061,3484,8845,4234,4611,107Y09M
68000,68000010,68000010-019,819,1908,925,983,107Y09M
68000,68000010,68000010-018,1188,3685,1890,1795,107Y09M
68000,68000010,68000010-025,658,1737,828,909,107Y09M
68000,68000010,68000010-010,2467,6212,3046,3166,107Y09M
68000,68000010,68000010-005,1636,4329,2066,2263,107Y09M
68000,68000010,68000010-073,1453,3942,1902,2040,107Y09M
68000,68000010,68000010-014,1013,2255,1146,1109,107Y09M
68000,68000010,68000010-013,1487,3455,1664,1791,107Y09M
68000,68000010,68000010-012,2056,5600,2690,2910,107Y09M
68000,68000010,68000010-003,890,1796,865,931,107Y09M
68000,68000010,68000010-016,1525,4410,2173,2237,107Y09M
68000,68000010,68000010-007,521,1209,612,597,107Y09M
68000,68000010,68000010-063,2214,5909,2844,3065,107Y09M
68000,68000010,68000010-038,1847,5326,2626,2700,107Y09M
68000,68000010,68000010-048,3219,8709,4225,4484,107Y09M
68000,68000010,68000010-026,2607,7046,3411,3635,107Y09M
68000,68000010,68000010-067,2244,5996,2824,3172,107Y09M
68000,68000010,68000010-027,651,1661,817,844,107Y09M
68000,68000010,68000010-042,2423,6132,3025,3107,107Y09M
68000,68000010,68000010-047,2847,7503,3726,3777,107Y09M
68000,68000010,68000010-053,1658,4449,2193,2256,107Y09M
68000,68000010,68000010-051,4133,10341,4951,5390,107Y09M
68000,68000010,68000010-039,951,2338,1152,1186,107Y09M
68000,68000010,68000010-032,2696,7525,3544,3981,107Y09M
68000,68000010,68000010-024,2777,7736,3698,4038,107Y09M
68000,68000010,68000010-022,4349,11428,5514,5914,107Y09M
68000,68000010,68000010-006,4355,11175,5407,5768,107Y09M
68000,68000010,68000010-075,2764,7383,3508,3875,107Y09M
68000,68000010,68000010-015,447,1145,585,560,107Y09M
68000,68000010,68000010-079,2110,5694,2670,3024,107Y09M
68000,68000010,68000010-044,1985,5212,2480,2732,107Y09M
68000,68000010,68000010-033,2445,7450,3597,3853,107Y09M
68000,68000010,68000010-035,1464,4171,2128,2043,107Y09M
68000,68000010,68000010-060,2432,6378,3070,3308,107Y09M
68000,68000010,68000010-036,2610,7019,3396,3623,107Y09M
68000,68000010,68000010-056,2231,6054,2971,3083,107Y09M
68000,68000010,68000010-071,2701,7259,3565,3694,107Y09M
68000,68000010,68000010-059,5202,10969,5745,5224,107Y09M
68000,68000010,68000010-041,2798,7548,3693,3855,107Y09M
68000,68000010,68000010-058,3858,10086,4904,5182,107Y09M
68000,68000010,68000010-074,3797,10243,4798,5445,107Y09M
68000,68000010,68000010-068,2965,7819,3664,4155,107Y09M
68000,68000130,68000130-001,831,2376,1302,1074,107Y09M
68000,68000130,68000130-006,239,855,455,400,107Y09M
68000,68000130,68000130-005,242,811,468,343,107Y09M
68000,68000130,68000130-007,244,956,493,463,107Y09M
68000,68000130,68000130-010,266,966,537,429,107Y09M
68000,68000130,68000130-008,526,1490,846,644,107Y09M
68000,68000130,68000130-003,254,904,483,421,107Y09M
68000,68000130,68000130-002,568,1679,870,809,107Y09M
68000,68000130,68000130-004,237,699,381,318,107Y09M
68000,68000130,68000130-009,428,1235,646,589,107Y09M
68000,68000110,68000110-020,443,1246,707,539,107Y09M
68000,68000110,68000110-007,878,2712,1417,1295,107Y09M
68000,68000110,68000110-012,714,1980,1060,920,107Y09M
68000,68000110,68000110-011,327,820,453,367,107Y09M
68000,68000110,68000110-022,522,1508,834,674,107Y09M
68000,68000110,68000110-016,856,2561,1378,1183,107Y09M
68000,68000110,68000110-015,582,1124,630,494,107Y09M
68000,68000110,68000110-013,393,1063,575,488,107Y09M
68000,68000110,68000110-010,716,2388,1254,1134,107Y09M
68000,68000110,68000110-014,501,1556,802,754,107Y09M
68000,68000110,68000110-009,533,1657,881,776,107Y09M
68000,68000110,68000110-008,540,1605,895,710,107Y09M
68000,68000110,68000110-021,425,1238,712,526,107Y09M
68000,68000110,68000110-003,561,1857,987,870,107Y09M
68000,68000110,68000110-006,925,3011,1605,1406,107Y09M
68000,68000110,68000110-023,575,1601,930,671,107Y09M
68000,68000110,68000110-004,1567,4772,2510,2262,107Y09M
68000,68000110,68000110-018,288,756,425,331,107Y09M
68000,68000110,68000110-017,422,1197,660,537,107Y09M
68000,68000110,68000110-019,364,1053,580,473,107Y09M
68000,68000110,68000110-002,1531,4983,2509,2474,107Y09M
68000,68000110,68000110-001,1142,3502,1778,1724,107Y09M
68000,68000110,68000110-005,1686,4932,2548,2384,107Y09M
68000,68000040,68000040-040,1497,4485,2163,2322,107Y09M
68000,68000040,68000040-024,1023,3207,1652,1555,107Y09M
68000,68000040,68000040-008,959,3069,1639,1430,107Y09M
68000,68000040,68000040-025,2277,6329,3277,3052,107Y09M
68000,68000040,68000040-005,1175,3840,1980,1860,107Y09M
68000,68000040,68000040-010,1253,4062,2070,1992,107Y09M
68000,68000040,68000040-026,1244,3777,1808,1969,107Y09M
68000,68000040,68000040-018,1586,4545,2293,2252,107Y09M
68000,68000040,68000040-007,1529,4956,2584,2372,107Y09M
68000,68000040,68000040-014,1946,5359,2669,2690,107Y09M
68000,68000040,68000040-035,835,2279,1160,1119,107Y09M
68000,68000040,68000040-004,3409,8627,4333,4294,107Y09M
68000,68000040,68000040-019,1362,3769,1865,1904,107Y09M
68000,68000040,68000040-030,1194,4022,2065,1957,107Y09M
68000,68000040,68000040-006,1165,3283,1751,1532,107Y09M
68000,68000040,68000040-028,1758,4804,2334,2470,107Y09M
68000,68000040,68000040-012,588,1403,668,735,107Y09M
68000,68000040,68000040-031,1991,4592,2258,2334,107Y09M
68000,68000040,68000040-003,1058,3180,1600,1580,107Y09M
68000,68000040,68000040-022,1107,3250,1735,1515,107Y09M
68000,68000040,68000040-011,569,1667,836,831,107Y09M
68000,68000040,68000040-037,1051,3283,1759,1524,107Y09M
68000,68000040,68000040-016,1644,4609,2279,2330,107Y09M
68000,68000040,68000040-017,1397,4103,2072,2031,107Y09M
68000,68000040,68000040-009,780,2427,1216,1211,107Y09M
68000,68000040,68000040-015,1730,4645,2312,2333,107Y09M
68000,68000040,68000040-020,757,2170,1098,1072,107Y09M
68000,68000040,68000040-038,1175,3423,1831,1592,107Y09M
68000,68000040,68000040-032,1413,4432,2171,2261,107Y09M
68000,68000040,68000040-002,438,1286,643,643,107Y09M
68000,68000040,68000040-027,3177,8201,4019,4182,107Y09M
68000,68000040,68000040-001,1514,4680,2317,2363,107Y09M
68000,68000040,68000040-034,2413,7109,3555,3554,107Y09M
68000,68000040,68000040-023,1385,4469,2354,2115,107Y09M
68000,68000040,68000040-013,2443,6825,3346,3479,107Y09M
68000,68000040,68000040-036,1718,4520,2162,2358,107Y09M
68000,68000040,68000040-029,1437,3952,1960,1992,107Y09M
68000,68000040,68000040-039,1177,2940,1475,1465,107Y09M
68000,68000040,68000040-041,1269,3542,1746,1796,107Y09M
68000,68000040,68000040-021,1431,4606,2394,2212,107Y09M
68000,68000040,68000040-033,1304,4063,2025,2038,107Y09M
68000,68000090,68000090-013,1520,4317,2162,2155,107Y09M
68000,68000090,68000090-007,1646,4835,2466,2369,107Y09M
68000,68000090,68000090-008,267,771,421,350,107Y09M
68000,68000090,68000090-017,598,1746,930,816,107Y09M
68000,68000090,68000090-016,1148,2819,1450,1369,107Y09M
68000,68000090,68000090-019,1267,3512,1777,1735,107Y09M
68000,68000090,68000090-009,1698,5224,2623,2601,107Y09M
68000,68000090,68000090-026,1362,4066,1967,2099,107Y09M
68000,68000090,68000090-018,1150,2459,1229,1230,107Y09M
68000,68000090,68000090-002,2522,6932,3484,3448,107Y09M
68000,68000090,68000090-010,2308,7129,3453,3676,107Y09M
68000,68000090,68000090-014,1769,5174,2601,2573,107Y09M
68000,68000090,68000090-029,984,2785,1381,1404,107Y09M
68000,68000090,68000090-020,1115,3347,1673,1674,107Y09M
68000,68000090,68000090-022,2014,5098,2385,2713,107Y09M
68000,68000090,68000090-015,1536,4165,2091,2074,107Y09M
68000,68000090,68000090-028,1753,4798,2391,2407,107Y09M
68000,68000090,68000090-027,581,1826,927,899,107Y09M
68000,68000090,68000090-030,1523,4478,2224,2254,107Y09M
68000,68000090,68000090-006,1472,4364,2194,2170,107Y09M
68000,68000090,68000090-003,1638,4789,2364,2425,107Y09M
68000,68000090,68000090-021,930,2813,1445,1368,107Y09M
68000,68000090,68000090-004,1139,3740,1926,1814,107Y09M
68000,68000090,68000090-012,1725,5258,2668,2590,107Y09M
68000,68000090,68000090-032,586,1685,826,859,107Y09M
68000,68000090,68000090-031,1431,4045,1965,2080,107Y09M
68000,68000090,68000090-001,1762,5525,2837,2688,107Y09M
68000,68000090,68000090-024,1220,3560,1812,1748,107Y09M
68000,68000090,68000090-025,1639,5145,2529,2616,107Y09M
68000,68000090,68000090-023,1418,4239,2137,2102,107Y09M
68000,68000090,68000090-011,704,2261,1156,1105,107Y09M
68000,68000070,68000070-004,2575,7172,3556,3616,107Y09M
68000,68000070,68000070-012,849,2289,1189,1100,107Y09M
68000,68000070,68000070-019,1790,4844,2509,2335,107Y09M
68000,68000070,68000070-027,2921,6291,2975,3316,107Y09M
68000,68000070,68000070-028,4292,11213,5504,5709,107Y09M
68000,68000070,68000070-006,2464,6480,3341,3139,107Y09M
68000,68000070,68000070-005,1413,3859,1927,1932,107Y09M
68000,68000070,68000070-014,2052,5611,2797,2814,107Y09M
68000,68000070,68000070-013,2166,5671,2819,2852,107Y09M
68000,68000070,68000070-009,514,1359,687,672,107Y09M
68000,68000070,68000070-020,3288,7544,3615,3929,107Y09M
68000,68000070,68000070-031,3842,7638,3613,4025,107Y09M
68000,68000070,68000070-003,1855,5267,2763,2504,107Y09M
68000,68000070,68000070-022,2298,6190,3132,3058,107Y09M
68000,68000070,68000070-029,2201,4997,2150,2847,107Y09M
68000,68000070,68000070-011,934,2224,1118,1106,107Y09M
68000,68000070,68000070-021,1069,2963,1465,1498,107Y09M
68000,68000070,68000070-025,2739,6747,3344,3403,107Y09M
68000,68000070,68000070-007,1686,4177,2008,2169,107Y09M
68000,68000070,68000070-015,2385,6534,3236,3298,107Y09M
68000,68000070,68000070-030,1716,3430,1909,1521,107Y09M
68000,68000070,68000070-026,1637,4610,2362,2248,107Y09M
68000,68000070,68000070-032,1304,3862,1899,1963,107Y09M
68000,68000070,68000070-001,1563,4552,2297,2255,107Y09M
68000,68000070,68000070-023,798,2353,1215,1138,107Y09M
68000,68000070,68000070-008,2590,6395,3130,3265,107Y09M
68000,68000070,68000070-010,1636,4205,2151,2054,107Y09M
68000,68000070,68000070-024,1522,3795,1909,1886,107Y09M
68000,68000070,68000070-017,769,2016,1028,988,107Y09M
68000,68000070,68000070-002,2959,8254,4059,4195,107Y09M
68000,68000070,68000070-016,1623,4710,2452,2258,107Y09M
68000,68000070,68000070-018,1041,2815,1447,1368,107Y09M
68000,68000050,68000050-022,1437,4342,2194,2148,107Y09M
68000,68000050,68000050-037,1469,4115,2025,2090,107Y09M
68000,68000050,68000050-004,2070,5988,2969,3019,107Y09M
68000,68000050,68000050-012,1286,4344,2244,2100,107Y09M
68000,68000050,68000050-011,675,2085,1071,1014,107Y09M
68000,68000050,68000050-033,1476,4106,1942,2164,107Y09M
68000,68000050,68000050-002,1543,4654,2435,2219,107Y09M
68000,68000050,68000050-036,2353,6231,2986,3245,107Y09M
68000,68000050,68000050-009,1070,3033,1499,1534,107Y09M
68000,68000050,68000050-010,1241,2991,1660,1331,107Y09M
68000,68000050,68000050-013,525,1785,975,810,107Y09M
68000,68000050,68000050-039,1986,5562,2710,2852,107Y09M
68000,68000050,68000050-024,1662,3991,1934,2057,107Y09M
68000,68000050,68000050-032,1786,4658,2209,2449,107Y09M
68000,68000050,68000050-026,2057,5722,2749,2973,107Y09M
68000,68000050,68000050-015,1015,2968,1550,1418,107Y09M
68000,68000050,68000050-014,577,1958,1072,886,107Y09M
68000,68000050,68000050-023,1229,3617,1940,1677,107Y09M
68000,68000050,68000050-031,2584,7124,3449,3675,107Y09M
68000,68000050,68000050-019,1152,3158,1598,1560,107Y09M
68000,68000050,68000050-007,1739,4309,2122,2187,107Y09M
68000,68000050,68000050-017,1523,3914,1857,2057,107Y09M
68000,68000050,68000050-018,2648,6685,3216,3469,107Y09M
68000,68000050,68000050-016,1198,3600,1813,1787,107Y09M
68000,68000050,68000050-021,543,1582,845,737,107Y09M
68000,68000050,68000050-027,1952,4724,2264,2460,107Y09M
68000,68000050,68000050-003,2007,5884,3003,2881,107Y09M
68000,68000050,68000050-001,1188,3398,1790,1608,107Y09M
68000,68000050,68000050-028,2545,6540,3158,3382,107Y09M
68000,68000050,68000050-034,1426,4140,1937,2203,107Y09M
68000,68000050,68000050-029,1848,4565,2171,2394,107Y09M
68000,68000050,68000050-035,1317,3547,1676,1871,107Y09M
68000,68000050,68000050-020,1528,3925,1903,2022,107Y09M
68000,68000050,68000050-008,1592,4753,2307,2446,107Y09M
68000,68000050,68000050-040,1079,3028,1553,1475,107Y09M
68000,68000050,68000050-038,1482,4070,1990,2080,107Y09M
68000,68000050,68000050-025,2159,5913,2901,3012,107Y09M
68000,68000050,68000050-006,1648,4823,2533,2290,107Y09M
68000,68000050,68000050-030,641,2050,1069,981,107Y09M
68000,68000120,68000120-007,346,1016,534,482,107Y09M
68000,68000120,68000120-016,943,2751,1456,1295,107Y09M
68000,68000120,68000120-012,1263,3867,1957,1910,107Y09M
68000,68000120,68000120-013,584,1770,946,824,107Y09M
68000,68000120,68000120-004,766,1967,1016,951,107Y09M
68000,68000120,68000120-002,496,1170,638,532,107Y09M
68000,68000120,68000120-009,646,1881,1056,825,107Y09M
68000,68000120,68000120-005,372,1070,571,499,107Y09M
68000,68000120,68000120-010,1047,3148,1660,1488,107Y09M
68000,68000120,68000120-006,905,2455,1300,1155,107Y09M
68000,68000120,68000120-020,800,2445,1279,1166,107Y09M
68000,68000120,68000120-024,2333,7127,3523,3604,107Y09M
68000,68000120,68000120-021,886,2517,1294,1223,107Y09M
68000,68000120,68000120-014,1862,5721,2928,2793,107Y09M
68000,68000120,68000120-023,773,2402,1245,1157,107Y09M
68000,68000120,68000120-015,1639,4592,2314,2278,107Y09M
68000,68000120,68000120-019,420,1251,701,550,107Y09M
68000,68000120,68000120-017,1127,3553,1842,1711,107Y09M
68000,68000120,68000120-008,272,813,472,341,107Y09M
68000,68000120,68000120-018,929,2945,1543,1402,107Y09M
68000,68000120,68000120-003,583,1664,923,741,107Y09M
68000,68000120,68000120-022,1867,4767,2401,2366,107Y09M
68000,68000120,68000120-011,1012,2945,1560,1385,107Y09M
68000,68000120,68000120-001,1279,3283,1743,1540,107Y09M
64000,64000050,64000050-084,483,1228,647,581,107Y09M
64000,64000050,64000050-063,760,1913,944,969,107Y09M
64000,64000050,64000050-064,829,2047,1003,1044,107Y09M
64000,64000050,64000050-087,467,1174,570,604,107Y09M
64000,64000050,64000050-088,980,2253,1133,1120,107Y09M
64000,64000050,64000050-085,553,1247,591,656,107Y09M
64000,64000050,64000050-082,565,1372,722,650,107Y09M
64000,64000050,64000050-014,2037,5958,2835,3123,107Y09M
64000,64000050,64000050-012,2288,6404,3028,3376,107Y09M
64000,64000050,64000050-010,938,2265,1106,1159,107Y09M
64000,64000050,64000050-013,1931,5724,2762,2962,107Y09M
64000,64000050,64000050-009,3177,8138,3939,4199,107Y09M
64000,64000050,64000050-011,760,2104,1033,1071,107Y09M
64000,64000050,64000050-015,3317,9340,4451,4889,107Y09M
64000,64000050,64000050-008,3995,9757,4767,4990,107Y09M
64000,64000050,64000050-039,1918,4619,2208,2411,107Y09M
64000,64000050,64000050-038,5448,13950,6578,7372,107Y09M
64000,64000050,64000050-059,895,2275,1100,1175,107Y09M
64000,64000050,64000050-067,463,1105,533,572,107Y09M
64000,64000050,64000050-066,325,773,364,409,107Y09M
64000,64000050,64000050-086,558,1292,642,650,107Y09M
64000,64000050,64000050-052,1277,3008,1503,1505,107Y09M
64000,64000050,64000050-055,671,1639,807,832,107Y09M
64000,64000050,64000050-044,2234,5239,2446,2793,107Y09M
64000,64000050,64000050-062,2051,4616,2386,2230,107Y09M
64000,64000050,64000050-047,1067,2817,1405,1412,107Y09M
64000,64000050,64000050-060,1341,3547,1708,1839,107Y09M
64000,64000050,64000050-046,1278,3295,1594,1701,107Y09M
64000,64000050,64000050-061,1789,4326,2094,2232,107Y09M
64000,64000050,64000050-042,1361,3151,1579,1572,107Y09M
64000,64000050,64000050-045,2086,5159,2428,2731,107Y09M
64000,64000050,64000050-043,936,2063,1018,1045,107Y09M
64000,64000050,64000050-074,558,1218,614,604,107Y09M
64000,64000050,64000050-075,759,1305,614,691,107Y09M
64000,64000050,64000050-073,1970,4760,2273,2487,107Y09M
64000,64000050,64000050-072,646,1296,650,646,107Y09M
64000,64000050,64000050-070,458,871,446,425,107Y09M
64000,64000050,64000050-068,805,1528,754,774,107Y09M
64000,64000050,64000050-069,718,1616,792,824,107Y09M
64000,64000050,64000050-083,599,1496,761,735,107Y09M
64000,64000050,64000050-050,659,1704,822,882,107Y09M
64000,64000050,64000050-049,675,1703,828,875,107Y09M
64000,64000050,64000050-051,480,1114,554,560,107Y09M
64000,64000050,64000050-048,583,1513,760,753,107Y09M
64000,64000050,64000050-004,1641,4420,2144,2276,107Y09M
64000,64000050,64000050-006,1490,3797,1881,1916,107Y09M
64000,64000050,64000050-005,3327,8248,3961,4287,107Y09M
64000,64000050,64000050-001,1724,4423,2180,2243,107Y09M
64000,64000050,64000050-007,9862,25397,11868,13529,107Y09M
64000,64000050,64000050-003,1693,4653,2304,2349,107Y09M
64000,64000050,64000050-002,3418,9068,4365,4703,107Y09M
64000,64000050,64000050-058,717,1665,802,863,107Y09M
64000,64000050,64000050-078,650,1558,789,769,107Y09M
64000,64000050,64000050-077,420,954,482,472,107Y09M
64000,64000050,64000050-054,930,2153,1060,1093,107Y09M
64000,64000050,64000050-065,881,2043,1015,1028,107Y09M
64000,64000050,64000050-057,482,1221,602,619,107Y09M
64000,64000050,64000050-079,330,886,453,433,107Y09M
64000,64000050,64000050-056,390,898,453,445,107Y09M
64000,64000050,64000050-053,994,2511,1220,1291,107Y09M
64000,64000050,64000050-076,911,1934,940,994,107Y09M
64000,64000050,64000050-081,1113,2768,1352,1416,107Y09M
64000,64000050,64000050-020,1284,3549,1726,1823,107Y09M
64000,64000050,64000050-023,1406,3682,1812,1870,107Y09M
64000,64000050,64000050-030,3740,9970,4677,5293,107Y09M
64000,64000050,64000050-027,3319,7901,3686,4215,107Y09M
64000,64000050,64000050-018,1956,4509,2108,2401,107Y09M
64000,64000050,64000050-029,3488,7036,3679,3357,107Y09M
64000,64000050,64000050-022,3550,9773,4616,5157,107Y09M
64000,64000050,64000050-026,2286,5652,2744,2908,107Y09M
64000,64000050,64000050-021,1420,3710,1719,1991,107Y09M
64000,64000050,64000050-025,2544,6634,3108,3526,107Y09M
64000,64000050,64000050-016,1610,4026,1964,2062,107Y09M
64000,64000050,64000050-017,2246,5734,2747,2987,107Y09M
64000,64000050,64000050-024,1183,3250,1546,1704,107Y09M
64000,64000050,64000050-019,3084,7488,3513,3975,107Y09M
64000,64000050,64000050-028,1869,4893,2377,2516,107Y09M
64000,64000050,64000050-031,1956,4388,2135,2253,107Y09M
64000,64000050,64000050-033,2752,5878,2853,3025,107Y09M
64000,64000050,64000050-041,1056,2644,1322,1322,107Y09M
64000,64000050,64000050-036,1458,3502,1731,1771,107Y09M
64000,64000050,64000050-035,858,2116,1042,1074,107Y09M
64000,64000050,64000050-037,1862,3995,1971,2024,107Y09M
64000,64000050,64000050-034,1336,2924,1450,1474,107Y09M
64000,64000050,64000050-032,1437,3373,1689,1684,107Y09M
64000,64000050,64000050-040,833,2285,1128,1157,107Y09M
64000,64000160,64000160-005,1173,3038,1569,1469,107Y09M
64000,64000160,64000160-003,2246,5700,2883,2817,107Y09M
64000,64000160,64000160-008,1327,3689,1893,1796,107Y09M
64000,64000160,64000160-009,1322,3622,1814,1808,107Y09M
64000,64000160,64000160-002,1470,3591,1826,1765,107Y09M
64000,64000160,64000160-007,2190,5711,2861,2850,107Y09M
64000,64000160,64000160-001,429,1085,562,523,107Y09M
64000,64000160,64000160-004,716,1927,956,971,107Y09M
64000,64000160,64000160-006,2260,6232,3153,3079,107Y09M
64000,64000140,64000140-005,1963,5239,2701,2538,107Y09M
64000,64000140,64000140-004,997,2804,1456,1348,107Y09M
64000,64000140,64000140-003,2894,7871,3982,3889,107Y09M
64000,64000140,64000140-017,3204,8643,4280,4363,107Y09M
64000,64000140,64000140-009,4567,12701,6408,6293,107Y09M
64000,64000140,64000140-025,3040,7476,3664,3812,107Y09M
64000,64000140,64000140-002,2787,6835,3543,3292,107Y09M
64000,64000140,64000140-019,2929,7978,4021,3957,107Y09M
64000,64000140,64000140-024,108,204,111,93,107Y09M
64000,64000140,64000140-022,777,2127,1066,1061,107Y09M
64000,64000140,64000140-018,289,601,292,309,107Y09M
64000,64000140,64000140-008,930,2545,1324,1221,107Y09M
64000,64000140,64000140-010,3360,8961,4480,4481,107Y09M
64000,64000140,64000140-001,611,1645,844,801,107Y09M
64000,64000140,64000140-023,1694,4088,2169,1919,107Y09M
64000,64000140,64000140-006,1760,5011,2592,2419,107Y09M
64000,64000140,64000140-007,1499,4456,2330,2126,107Y09M
64000,64000140,64000140-012,735,1901,985,916,107Y09M
64000,64000140,64000140-016,2980,7050,3664,3386,107Y09M
64000,64000140,64000140-015,709,1763,961,802,107Y09M
64000,64000140,64000140-021,595,1754,944,810,107Y09M
64000,64000140,64000140-011,859,2024,1088,936,107Y09M
64000,64000140,64000140-020,964,2453,1278,1175,107Y09M
64000,64000140,64000140-013,1094,2869,1485,1384,107Y09M
64000,64000140,64000140-014,1139,3400,1781,1619,107Y09M
64000,64000150,64000150-002,2123,5956,2960,2996,107Y09M
64000,64000150,64000150-015,413,1148,596,552,107Y09M
64000,64000150,64000150-003,1660,4753,2367,2386,107Y09M
64000,64000150,64000150-010,530,1674,873,801,107Y09M
64000,64000150,64000150-014,924,2871,1536,1335,107Y09M
64000,64000150,64000150-012,489,1531,806,725,107Y09M
64000,64000150,64000150-011,531,1819,978,841,107Y09M
64000,64000150,64000150-004,859,2671,1394,1277,107Y09M
64000,64000150,64000150-005,788,2615,1380,1235,107Y09M
64000,64000150,64000150-001,1041,3096,1612,1484,107Y09M
64000,64000150,64000150-008,307,1142,594,548,107Y09M
64000,64000150,64000150-009,334,1098,583,515,107Y09M
64000,64000150,64000150-018,257,790,391,399,107Y09M
64000,64000150,64000150-016,596,1838,969,869,107Y09M
64000,64000150,64000150-007,370,1268,676,592,107Y09M
64000,64000150,64000150-017,534,2169,912,1257,107Y09M
64000,64000150,64000150-013,608,2019,1106,913,107Y09M
64000,64000150,64000150-006,1299,4028,2030,1998,107Y09M
64000,64000110,64000110-012,1984,4319,2152,2167,107Y09M
64000,64000110,64000110-013,1457,3249,1583,1666,107Y09M
64000,64000110,64000110-026,1125,3264,1634,1630,107Y09M
64000,64000110,64000110-011,1252,2903,1405,1498,107Y09M
64000,64000110,64000110-001,1127,2728,1380,1348,107Y09M
64000,64000110,64000110-022,5634,13801,6710,7091,107Y09M
64000,64000110,64000110-018,1551,3425,1717,1708,107Y09M
64000,64000110,64000110-032,1659,4237,2171,2066,107Y09M
64000,64000110,64000110-016,1184,3279,1570,1709,107Y09M
64000,64000110,64000110-028,2182,5202,2616,2586,107Y09M
64000,64000110,64000110-014,2013,4920,2414,2506,107Y09M
64000,64000110,64000110-030,1151,3066,1562,1504,107Y09M
64000,64000110,64000110-017,1571,4018,1949,2069,107Y09M
64000,64000110,64000110-027,2632,6937,3539,3398,107Y09M
64000,64000110,64000110-010,3051,6833,3413,3420,107Y09M
64000,64000110,64000110-025,1525,3585,1782,1803,107Y09M
64000,64000110,64000110-024,1193,3055,1526,1529,107Y09M
64000,64000110,64000110-019,1202,2635,1282,1353,107Y09M
64000,64000110,64000110-031,3597,9300,4559,4741,107Y09M
64000,64000110,64000110-021,1544,3861,1913,1948,107Y09M
64000,64000110,64000110-023,1902,4577,2311,2266,107Y09M
64000,64000110,64000110-002,1554,3687,1839,1848,107Y09M
64000,64000110,64000110-003,1216,3055,1545,1510,107Y09M
64000,64000110,64000110-006,1193,3086,1569,1517,107Y09M
64000,64000110,64000110-005,1443,3749,1869,1880,107Y09M
64000,64000110,64000110-007,1388,2782,1475,1307,107Y09M
64000,64000110,64000110-004,833,2013,991,1022,107Y09M
64000,64000110,64000110-008,1155,2637,1340,1297,107Y09M
64000,64000110,64000110-015,2282,5339,2567,2772,107Y09M
64000,64000110,64000110-029,1759,4145,2071,2074,107Y09M
64000,64000110,64000110-036,2064,3441,1654,1787,107Y09M
64000,64000110,64000110-009,1347,3085,1531,1554,107Y09M
64000,64000110,64000110-035,1478,2497,1225,1272,107Y09M
64000,64000110,64000110-038,2473,4201,2101,2100,107Y09M
64000,64000110,64000110-033,1948,3548,1770,1778,107Y09M
64000,64000110,64000110-037,1704,2881,1415,1466,107Y09M
64000,64000110,64000110-034,2073,3526,1749,1777,107Y09M
64000,64000110,64000110-020,2082,4748,2344,2404,107Y09M
64000,64000170,64000170-009,7685,18838,9480,9358,107Y09M
64000,64000170,64000170-001,2039,4730,2401,2329,107Y09M
64000,64000170,64000170-012,835,1831,973,858,107Y09M
64000,64000170,64000170-013,2106,5442,2793,2649,107Y09M
64000,64000170,64000170-014,1615,4565,2319,2246,107Y09M
64000,64000170,64000170-006,2536,6401,3335,3066,107Y09M
64000,64000170,64000170-016,989,2520,1254,1266,107Y09M
64000,64000170,64000170-005,348,937,474,463,107Y09M
64000,64000170,64000170-007,3845,10592,5357,5235,107Y09M
64000,64000170,64000170-008,1071,2479,1267,1212,107Y09M
64000,64000170,64000170-003,1175,2943,1539,1404,107Y09M
64000,64000170,64000170-015,2743,7316,3671,3645,107Y09M
64000,64000170,64000170-011,1161,2944,1512,1432,107Y09M
64000,64000170,64000170-004,1384,4549,2268,2281,107Y09M
64000,64000170,64000170-010,951,2176,1102,1074,107Y09M
64000,64000170,64000170-002,3535,9114,4557,4557,107Y09M
64000,64000350,64000350-014,273,756,417,339,107Y09M
64000,64000350,64000350-010,228,622,335,287,107Y09M
64000,64000350,64000350-011,340,887,497,390,107Y09M
64000,64000350,64000350-007,363,1115,573,542,107Y09M
64000,64000350,64000350-012,162,458,261,197,107Y09M
64000,64000350,64000350-008,467,1376,721,655,107Y09M
64000,64000350,64000350-016,217,670,376,294,107Y09M
64000,64000350,64000350-015,237,648,381,267,107Y09M
64000,64000350,64000350-004,179,459,259,200,107Y09M
64000,64000350,64000350-003,364,1093,581,512,107Y09M
64000,64000350,64000350-005,175,444,250,194,107Y09M
64000,64000350,64000350-006,188,559,288,271,107Y09M
64000,64000350,64000350-018,265,756,385,371,107Y09M
64000,64000350,64000350-013,189,550,302,248,107Y09M
64000,64000350,64000350-002,277,710,393,317,107Y09M
64000,64000350,64000350-001,362,1083,604,479,107Y09M
64000,64000350,64000350-017,159,375,197,178,107Y09M
64000,64000350,64000350-009,684,1928,1009,919,107Y09M
64000,64000320,64000320-012,162,352,193,159,107Y09M
64000,64000320,64000320-009,700,1616,858,758,107Y09M
64000,64000320,64000320-006,476,1100,604,496,107Y09M
64000,64000320,64000320-011,720,1678,929,749,107Y09M
64000,64000320,64000320-005,664,1582,839,743,107Y09M
64000,64000320,64000320-001,355,837,486,351,107Y09M
64000,64000320,64000320-004,529,1136,621,515,107Y09M
64000,64000320,64000320-003,304,779,427,352,107Y09M
64000,64000320,64000320-002,308,725,393,332,107Y09M
64000,64000320,64000320-007,509,1202,622,580,107Y09M
64000,64000320,64000320-008,378,941,505,436,107Y09M
64000,64000320,64000320-010,466,1041,531,510,107Y09M
64000,64000030,64000030-027,201,463,247,216,107Y09M
64000,64000030,64000030-028,289,659,360,299,107Y09M
64000,64000030,64000030-004,286,708,357,351,107Y09M
64000,64000030,64000030-005,249,567,323,244,107Y09M
64000,64000030,64000030-013,379,1001,508,493,107Y09M
64000,64000030,64000030-016,1209,2866,1380,1486,107Y09M
64000,64000030,64000030-017,1273,2889,1477,1412,107Y09M
64000,64000030,64000030-035,184,402,213,189,107Y09M
64000,64000030,64000030-009,1597,3702,1879,1823,107Y09M
64000,64000030,64000030-002,477,1149,582,567,107Y09M
64000,64000030,64000030-008,364,815,411,404,107Y09M
64000,64000030,64000030-019,370,795,385,410,107Y09M
64000,64000030,64000030-038,831,1778,843,935,107Y09M
64000,64000030,64000030-037,770,1610,755,855,107Y09M
64000,64000030,64000030-036,1495,2990,1397,1593,107Y09M
64000,64000030,64000030-025,233,571,298,273,107Y09M
64000,64000030,64000030-011,883,1773,829,944,107Y09M
64000,64000030,64000030-032,2799,6420,3060,3360,107Y09M
64000,64000030,64000030-030,748,1441,744,697,107Y09M
64000,64000030,64000030-029,424,966,497,469,107Y09M
64000,64000030,64000030-031,501,1144,593,551,107Y09M
64000,64000030,64000030-034,1770,3696,1769,1927,107Y09M
64000,64000030,64000030-012,204,390,181,209,107Y09M
64000,64000030,64000030-015,792,1992,983,1009,107Y09M
64000,64000030,64000030-003,272,603,303,300,107Y09M
64000,64000030,64000030-021,433,1047,539,508,107Y09M
64000,64000030,64000030-043,13181,35093,16685,18408,107Y09M
64000,64000030,64000030-001,1678,2766,1563,1203,107Y09M
64000,64000030,64000030-039,6486,15697,7345,8352,107Y09M
64000,64000030,64000030-040,12155,30441,14301,16140,107Y09M
64000,64000030,64000030-041,2047,5863,2927,2936,107Y09M
64000,64000030,64000030-042,6201,16472,7831,8641,107Y09M
64000,64000030,64000030-022,360,814,436,378,107Y09M
64000,64000030,64000030-023,171,364,216,148,107Y09M
64000,64000030,64000030-024,217,596,299,297,107Y09M
64000,64000030,64000030-026,323,810,427,383,107Y09M
64000,64000030,64000030-044,16656,43504,20591,22913,107Y09M
64000,64000030,64000030-007,436,981,509,472,107Y09M
64000,64000030,64000030-006,367,907,473,434,107Y09M
64000,64000270,64000270-001,763,1797,916,881,107Y09M
64000,64000270,64000270-002,917,2060,1062,998,107Y09M
64000,64000270,64000270-005,1207,2956,1499,1457,107Y09M
64000,64000270,64000270-003,1090,2639,1319,1320,107Y09M
64000,64000270,64000270-006,1558,4019,1980,2039,107Y09M
64000,64000270,64000270-004,202,428,227,201,107Y09M
64000,64000220,64000220-005,396,650,350,300,107Y09M
64000,64000220,64000220-008,203,412,236,176,107Y09M
64000,64000220,64000220-003,194,401,223,178,107Y09M
64000,64000220,64000220-009,266,559,324,235,107Y09M
64000,64000220,64000220-004,196,400,207,193,107Y09M
64000,64000220,64000220-007,373,868,487,381,107Y09M
64000,64000220,64000220-002,531,1136,652,484,107Y09M
64000,64000220,64000220-006,383,1045,557,488,107Y09M
64000,64000220,64000220-001,162,402,224,178,107Y09M
64000,64000220,64000220-010,550,1330,717,613,107Y09M
64000,64000330,64000330-004,647,1797,953,844,107Y09M
64000,64000330,64000330-007,242,617,339,278,107Y09M
64000,64000330,64000330-002,392,1002,497,505,107Y09M
64000,64000330,64000330-003,314,735,384,351,107Y09M
64000,64000330,64000330-001,210,516,271,245,107Y09M
64000,64000330,64000330-006,251,669,367,302,107Y09M
64000,64000330,64000330-005,245,729,409,320,107Y09M
64000,64000340,64000340-005,762,1776,967,809,107Y09M
64000,64000340,64000340-008,867,2364,1237,1127,107Y09M
64000,64000340,64000340-006,696,1778,969,809,107Y09M
64000,64000340,64000340-007,552,1417,777,640,107Y09M
64000,64000340,64000340-002,319,753,434,319,107Y09M
64000,64000340,64000340-001,297,710,390,320,107Y09M
64000,64000340,64000340-003,601,1401,812,589,107Y09M
64000,64000340,64000340-004,715,1644,888,756,107Y09M
64000,64000380,64000380-003,195,624,332,292,107Y09M
64000,64000380,64000380-001,428,1713,886,827,107Y09M
64000,64000380,64000380-002,218,804,390,414,107Y09M
64000,64000190,64000190-015,368,990,509,481,107Y09M
64000,64000190,64000190-029,434,1172,624,548,107Y09M
64000,64000190,64000190-006,493,1488,776,712,107Y09M
64000,64000190,64000190-033,957,2141,1024,1117,107Y09M
64000,64000190,64000190-016,1461,3852,1876,1976,107Y09M
64000,64000190,64000190-020,2286,6910,3329,3581,107Y09M
64000,64000190,64000190-001,528,1335,651,684,107Y09M
64000,64000190,64000190-025,776,2041,1039,1002,107Y09M
64000,64000190,64000190-022,769,2174,1099,1075,107Y09M
64000,64000190,64000190-023,755,2169,1097,1072,107Y09M
64000,64000190,64000190-019,2834,8657,4212,4445,107Y09M
64000,64000190,64000190-011,1369,4226,2067,2159,107Y09M
64000,64000190,64000190-030,942,2483,1202,1281,107Y09M
64000,64000190,64000190-008,127,358,184,174,107Y09M
64000,64000190,64000190-002,2035,5167,2629,2538,107Y09M
64000,64000190,64000190-007,1453,3423,1644,1779,107Y09M
64000,64000190,64000190-013,734,1864,915,949,107Y09M
64000,64000190,64000190-009,1197,3372,1629,1743,107Y09M
64000,64000190,64000190-012,2328,6415,3150,3265,107Y09M
64000,64000190,64000190-005,1845,4871,2357,2514,107Y09M
64000,64000190,64000190-031,259,777,417,360,107Y09M
64000,64000190,64000190-018,1688,4870,2434,2436,107Y09M
64000,64000190,64000190-028,681,1842,957,885,107Y09M
64000,64000190,64000190-027,672,2054,1065,989,107Y09M
64000,64000190,64000190-026,1435,3973,2023,1950,107Y09M
64000,64000190,64000190-003,1478,4067,1949,2118,107Y09M
64000,64000190,64000190-032,957,2736,1321,1415,107Y09M
64000,64000190,64000190-017,1692,4532,2292,2240,107Y09M
64000,64000190,64000190-024,426,1195,623,572,107Y09M
64000,64000190,64000190-004,452,1183,588,595,107Y09M
64000,64000190,64000190-010,599,1616,845,771,107Y09M
64000,64000190,64000190-014,325,875,482,393,107Y09M
64000,64000190,64000190-021,699,2211,1106,1105,107Y09M
64000,64000130,64000130-024,1279,2662,1354,1308,107Y09M
64000,64000130,64000130-017,804,2117,1085,1032,107Y09M
64000,64000130,64000130-006,1114,2893,1474,1419,107Y09M
64000,64000130,64000130-005,1185,3506,1812,1694,107Y09M
64000,64000130,64000130-023,1290,3100,1591,1509,107Y09M
64000,64000130,64000130-020,1244,3616,1807,1809,107Y09M
64000,64000130,64000130-021,1063,2798,1359,1439,107Y09M
64000,64000130,64000130-013,1615,4698,2363,2335,107Y09M
64000,64000130,64000130-011,894,1844,930,914,107Y09M
64000,64000130,64000130-019,410,847,442,405,107Y09M
64000,64000130,64000130-009,1444,4014,2028,1986,107Y09M
64000,64000130,64000130-018,471,982,507,475,107Y09M
64000,64000130,64000130-001,1263,3449,1717,1732,107Y09M
64000,64000130,64000130-012,858,2361,1199,1162,107Y09M
64000,64000130,64000130-014,561,1454,777,677,107Y09M
64000,64000130,64000130-002,1420,3897,1923,1974,107Y09M
64000,64000130,64000130-007,2033,5277,2661,2616,107Y09M
64000,64000130,64000130-008,813,2098,1069,1029,107Y09M
64000,64000130,64000130-010,691,1964,970,994,107Y09M
64000,64000130,64000130-003,1588,4718,2393,2325,107Y09M
64000,64000130,64000130-016,790,2083,1040,1043,107Y09M
64000,64000130,64000130-022,1376,4078,2049,2029,107Y09M
64000,64000130,64000130-004,1056,3240,1630,1610,107Y09M
64000,64000130,64000130-015,817,2174,1107,1067,107Y09M
64000,64000230,64000230-002,728,2363,1203,1160,107Y09M
64000,64000230,64000230-011,426,1162,627,535,107Y09M
64000,64000230,64000230-001,502,1482,759,723,107Y09M
64000,64000230,64000230-008,865,2727,1357,1370,107Y09M
64000,64000230,64000230-006,1906,5824,2882,2942,107Y09M
64000,64000230,64000230-009,601,1748,896,852,107Y09M
64000,64000230,64000230-012,1181,3525,1770,1755,107Y09M
64000,64000230,64000230-005,290,867,430,437,107Y09M
64000,64000230,64000230-007,1029,3121,1569,1552,107Y09M
64000,64000230,64000230-010,623,1908,950,958,107Y09M
64000,64000230,64000230-004,782,2507,1282,1225,107Y09M
64000,64000230,64000230-003,490,1428,739,689,107Y09M
64000,64000070,64000070-001,348,752,376,376,107Y09M
64000,64000070,64000070-019,449,988,474,514,107Y09M
64000,64000070,64000070-020,589,1324,614,710,107Y09M
64000,64000070,64000070-004,424,941,449,492,107Y09M
64000,64000070,64000070-010,425,837,373,464,107Y09M
64000,64000070,64000070-005,524,1074,516,558,107Y09M
64000,64000070,64000070-012,577,1086,617,469,107Y09M
64000,64000070,64000070-015,602,1204,548,656,107Y09M
64000,64000070,64000070-014,796,1736,791,945,107Y09M
64000,64000070,64000070-017,873,1856,874,982,107Y09M
64000,64000070,64000070-003,685,1484,724,760,107Y09M
64000,64000070,64000070-008,644,1198,559,639,107Y09M
64000,64000070,64000070-009,932,1837,832,1005,107Y09M
64000,64000070,64000070-007,342,787,397,390,107Y09M
64000,64000070,64000070-002,519,1141,551,590,107Y09M
64000,64000070,64000070-013,466,1057,509,548,107Y09M
64000,64000070,64000070-016,513,1107,529,578,107Y09M
64000,64000070,64000070-011,481,1061,480,581,107Y09M
64000,64000070,64000070-006,1886,4069,1913,2156,107Y09M
64000,64000070,64000070-018,563,1198,580,618,107Y09M
64000,64000090,64000090-005,728,1483,755,728,107Y09M
64000,64000090,64000090-008,325,709,366,343,107Y09M
64000,64000090,64000090-007,1775,3076,1728,1348,107Y09M
64000,64000090,64000090-029,1911,4769,2264,2505,107Y09M
64000,64000090,64000090-045,1549,3788,1799,1989,107Y09M
64000,64000090,64000090-040,1230,3168,1554,1614,107Y09M
64000,64000090,64000090-043,1068,2552,1240,1312,107Y09M
64000,64000090,64000090-044,1817,4767,2277,2490,107Y09M
64000,64000090,64000090-041,1096,2501,1189,1312,107Y09M
64000,64000090,64000090-042,3539,8485,3971,4514,107Y09M
64000,64000090,64000090-028,1740,3806,1826,1980,107Y09M
64000,64000090,64000090-033,1039,2272,1114,1158,107Y09M
64000,64000090,64000090-032,1337,3161,1564,1597,107Y09M
64000,64000090,64000090-038,1434,3079,1479,1600,107Y09M
64000,64000090,64000090-024,2565,5552,2662,2890,107Y09M
64000,64000090,64000090-025,1043,2436,1236,1200,107Y09M
64000,64000090,64000090-003,2562,5841,2988,2853,107Y09M
64000,64000090,64000090-002,1136,2737,1374,1363,107Y09M
64000,64000090,64000090-004,1118,2623,1335,1288,107Y09M
64000,64000090,64000090-012,581,1201,646,555,107Y09M
64000,64000090,64000090-009,782,1692,878,814,107Y09M
64000,64000090,64000090-010,708,1608,823,785,107Y09M
64000,64000090,64000090-011,1158,2568,1348,1220,107Y09M
64000,64000090,64000090-015,658,1495,785,710,107Y09M
64000,64000090,64000090-030,707,1449,700,749,107Y09M
64000,64000090,64000090-031,1253,2537,1217,1320,107Y09M
64000,64000090,64000090-001,4218,10887,5371,5516,107Y09M
64000,64000090,64000090-034,1492,3002,1384,1618,107Y09M
64000,64000090,64000090-035,1601,3325,1544,1781,107Y09M
64000,64000090,64000090-039,1301,3051,1486,1565,107Y09M
64000,64000090,64000090-059,1061,2735,1362,1373,107Y09M
64000,64000090,64000090-054,1477,3561,1735,1826,107Y09M
64000,64000090,64000090-052,1604,4503,2180,2323,107Y09M
64000,64000090,64000090-046,836,2030,966,1064,107Y09M
64000,64000090,64000090-055,1184,2917,1465,1452,107Y09M
64000,64000090,64000090-051,837,2442,1230,1212,107Y09M
64000,64000090,64000090-061,1562,3641,1754,1887,107Y09M
64000,64000090,64000090-050,1059,2849,1366,1483,107Y09M
64000,64000090,64000090-047,2040,5816,2910,2906,107Y09M
64000,64000090,64000090-056,1186,2862,1406,1456,107Y09M
64000,64000090,64000090-049,2070,5930,2818,3112,107Y09M
64000,64000090,64000090-060,1959,5131,2488,2643,107Y09M
64000,64000090,64000090-053,1522,4174,2038,2136,107Y09M
64000,64000090,64000090-058,1197,2865,1403,1462,107Y09M
64000,64000090,64000090-057,1093,2866,1409,1457,107Y09M
64000,64000090,64000090-048,1212,3498,1706,1792,107Y09M
64000,64000090,64000090-006,944,2141,1073,1068,107Y09M
64000,64000090,64000090-036,1545,3472,1667,1805,107Y09M
64000,64000090,64000090-014,400,788,410,378,107Y09M
64000,64000090,64000090-013,437,778,414,364,107Y09M
64000,64000090,64000090-021,1359,3250,1635,1615,107Y09M
64000,64000090,64000090-037,2569,6323,3019,3304,107Y09M
64000,64000090,64000090-022,412,837,458,379,107Y09M
64000,64000090,64000090-023,634,1198,611,587,107Y09M
64000,64000090,64000090-018,900,2270,1155,1115,107Y09M
64000,64000090,64000090-016,803,1877,958,919,107Y09M
64000,64000090,64000090-019,1933,4669,2312,2357,107Y09M
64000,64000090,64000090-020,494,1052,530,522,107Y09M
64000,64000090,64000090-017,1050,2492,1246,1246,107Y09M
64000,64000310,64000310-011,902,2371,1184,1187,107Y09M
64000,64000310,64000310-004,807,2332,1230,1102,107Y09M
64000,64000310,64000310-017,529,1531,832,699,107Y09M
64000,64000310,64000310-018,696,2094,1078,1016,107Y09M
64000,64000310,64000310-016,743,2113,1138,975,107Y09M
64000,64000310,64000310-002,1073,2749,1438,1311,107Y09M
64000,64000310,64000310-012,562,1378,729,649,107Y09M
64000,64000310,64000310-013,713,1770,907,863,107Y09M
64000,64000310,64000310-015,702,2033,1059,974,107Y09M
64000,64000310,64000310-007,1010,2847,1485,1362,107Y09M
64000,64000310,64000310-003,1056,2913,1510,1403,107Y09M
64000,64000310,64000310-001,1068,2883,1490,1393,107Y09M
64000,64000310,64000310-019,655,1669,878,791,107Y09M
64000,64000310,64000310-009,565,1515,809,706,107Y09M
64000,64000310,64000310-005,588,1686,870,816,107Y09M
64000,64000310,64000310-010,519,1295,709,586,107Y09M
64000,64000310,64000310-006,890,2377,1270,1107,107Y09M
64000,64000310,64000310-008,675,1597,864,733,107Y09M
64000,64000310,64000310-014,1048,2496,1305,1191,107Y09M
64000,64000260,64000260-009,438,1217,665,552,107Y09M
64000,64000260,64000260-003,742,1938,989,949,107Y09M
64000,64000260,64000260-008,370,1031,540,491,107Y09M
64000,64000260,64000260-010,464,1296,656,640,107Y09M
64000,64000260,64000260-014,457,1309,672,637,107Y09M
64000,64000260,64000260-007,1155,3337,1732,1605,107Y09M
64000,64000260,64000260-015,1997,5235,2711,2524,107Y09M
64000,64000260,64000260-002,381,1027,539,488,107Y09M
64000,64000260,64000260-005,655,2078,1050,1028,107Y09M
64000,64000260,64000260-006,485,1270,677,593,107Y09M
64000,64000260,64000260-012,451,1269,634,635,107Y09M
64000,64000260,64000260-013,404,1106,581,525,107Y09M
64000,64000260,64000260-011,711,2363,1192,1171,107Y09M
64000,64000260,64000260-004,1448,4480,2238,2242,107Y09M
64000,64000260,64000260-001,377,1096,567,529,107Y09M
64000,64000360,64000360-003,187,641,314,327,107Y09M
64000,64000360,64000360-001,274,914,470,444,107Y09M
64000,64000360,64000360-002,139,441,222,219,107Y09M
64000,64000080,64000080-013,940,1954,947,1007,107Y09M
64000,64000080,64000080-033,1428,3669,1649,2020,107Y09M
64000,64000080,64000080-062,1778,4133,2008,2125,107Y09M
64000,64000080,64000080-041,1054,2334,1103,1231,107Y09M
64000,64000080,64000080-014,636,1361,642,719,107Y09M
64000,64000080,64000080-067,1646,4333,2072,2261,107Y09M
64000,64000080,64000080-018,1057,2408,1142,1266,107Y09M
64000,64000080,64000080-061,2520,5725,2663,3062,107Y09M
64000,64000080,64000080-066,1160,2876,1373,1503,107Y09M
64000,64000080,64000080-063,1671,3996,1945,2051,107Y09M
64000,64000080,64000080-059,1036,2308,1102,1206,107Y09M
64000,64000080,64000080-060,1424,3128,1489,1639,107Y09M
64000,64000080,64000080-065,1109,2892,1481,1411,107Y09M
64000,64000080,64000080-064,1901,4615,2161,2454,107Y09M
64000,64000080,64000080-042,1808,4187,2050,2137,107Y09M
64000,64000080,64000080-058,1042,2422,1175,1247,107Y09M
64000,64000080,64000080-012,638,1436,714,722,107Y09M
64000,64000080,64000080-026,315,779,399,380,107Y09M
64000,64000080,64000080-035,1256,3366,1522,1844,107Y09M
64000,64000080,64000080-037,1103,2589,1210,1379,107Y09M
64000,64000080,64000080-020,961,2322,1173,1149,107Y09M
64000,64000080,64000080-034,847,1947,908,1039,107Y09M
64000,64000080,64000080-030,1358,3118,1504,1614,107Y09M
64000,64000080,64000080-025,786,1944,883,1061,107Y09M
64000,64000080,64000080-029,756,1731,842,889,107Y09M
64000,64000080,64000080-032,1548,3696,1676,2020,107Y09M
64000,64000080,64000080-031,978,2406,1123,1283,107Y09M
64000,64000080,64000080-024,1148,3084,1395,1689,107Y09M
64000,64000080,64000080-023,985,2543,1143,1400,107Y09M
64000,64000080,64000080-028,1253,3116,1490,1626,107Y09M
64000,64000080,64000080-044,848,2134,1024,1110,107Y09M
64000,64000080,64000080-047,747,1698,825,873,107Y09M
64000,64000080,64000080-045,1826,4447,2113,2334,107Y09M
64000,64000080,64000080-043,898,2004,949,1055,107Y09M
64000,64000080,64000080-027,621,1460,702,758,107Y09M
64000,64000080,64000080-007,727,1669,773,896,107Y09M
64000,64000080,64000080-008,267,629,305,324,107Y09M
64000,64000080,64000080-009,1065,2223,1069,1154,107Y09M
64000,64000080,64000080-038,739,1793,836,957,107Y09M
64000,64000080,64000080-068,829,2265,1152,1113,107Y09M
64000,64000080,64000080-016,559,1268,623,645,107Y09M
64000,64000080,64000080-046,883,2224,1053,1171,107Y09M
64000,64000080,64000080-004,796,1817,860,957,107Y09M
64000,64000080,64000080-003,588,1343,671,672,107Y09M
64000,64000080,64000080-006,715,1584,775,809,107Y09M
64000,64000080,64000080-002,831,1636,750,886,107Y09M
64000,64000080,64000080-005,722,1590,756,834,107Y09M
64000,64000080,64000080-036,1046,2635,1271,1364,107Y09M
64000,64000080,64000080-001,374,799,371,428,107Y09M
64000,64000080,64000080-022,1696,3846,1829,2017,107Y09M
64000,64000080,64000080-019,1564,3464,1628,1836,107Y09M
64000,64000080,64000080-021,1354,2294,1302,992,107Y09M
64000,64000080,64000080-048,661,1646,793,853,107Y09M
64000,64000080,64000080-017,1538,3329,1541,1788,107Y09M
64000,64000080,64000080-010,2132,4184,1969,2215,107Y09M
64000,64000080,64000080-011,465,1069,525,544,107Y09M
64000,64000080,64000080-053,922,2319,1159,1160,107Y09M
64000,64000080,64000080-054,1233,3007,1498,1509,107Y09M
64000,64000080,64000080-057,852,2012,984,1028,107Y09M
64000,64000080,64000080-055,1183,3039,1515,1524,107Y09M
64000,64000080,64000080-056,1182,2943,1420,1523,107Y09M
64000,64000080,64000080-040,811,1924,997,927,107Y09M
64000,64000080,64000080-051,488,1195,577,618,107Y09M
64000,64000080,64000080-052,865,2122,1070,1052,107Y09M
64000,64000080,64000080-050,539,1348,689,659,107Y09M
64000,64000080,64000080-049,1145,2849,1383,1466,107Y09M
64000,64000080,64000080-039,654,1573,795,778,107Y09M
64000,64000080,64000080-015,841,1973,993,980,107Y09M
64000,64000080,64000080-069,942,2184,1075,1109,107Y09M
64000,64000370,64000370-007,100,286,158,128,107Y09M
64000,64000370,64000370-003,215,763,382,381,107Y09M
64000,64000370,64000370-001,300,993,529,464,107Y09M
64000,64000370,64000370-004,245,806,421,385,107Y09M
64000,64000370,64000370-008,99,310,176,134,107Y09M
64000,64000370,64000370-006,111,346,182,164,107Y09M
64000,64000370,64000370-005,100,280,141,139,107Y09M
64000,64000370,64000370-002,185,526,280,246,107Y09M
64000,64000290,64000290-011,1464,4268,2207,2061,107Y09M
64000,64000290,64000290-005,484,1365,689,676,107Y09M
64000,64000290,64000290-010,411,1160,602,558,107Y09M
64000,64000290,64000290-013,351,946,504,442,107Y09M
64000,64000290,64000290-012,887,2532,1311,1221,107Y09M
64000,64000290,64000290-006,753,2070,1094,976,107Y09M
64000,64000290,64000290-015,1283,3319,1698,1621,107Y09M
64000,64000290,64000290-009,951,2752,1421,1331,107Y09M
64000,64000290,64000290-014,926,2659,1393,1266,107Y09M
64000,64000290,64000290-004,570,1757,887,870,107Y09M
64000,64000290,64000290-003,892,2632,1284,1348,107Y09M
64000,64000290,64000290-001,895,2489,1300,1189,107Y09M
64000,64000290,64000290-002,902,2374,1198,1176,107Y09M
64000,64000290,64000290-008,1109,3266,1708,1558,107Y09M
64000,64000290,64000290-007,813,2335,1195,1140,107Y09M
64000,64000180,64000180-006,305,791,409,382,107Y09M
64000,64000180,64000180-003,4601,10992,5451,5541,107Y09M
64000,64000180,64000180-005,2802,7351,3844,3507,107Y09M
64000,64000180,64000180-001,5258,11393,5732,5661,107Y09M
64000,64000180,64000180-007,1639,4552,2292,2260,107Y09M
64000,64000180,64000180-002,2417,5276,2629,2647,107Y09M
64000,64000180,64000180-004,1489,4024,2131,1893,107Y09M
64000,64000250,64000250-006,1566,4260,2133,2127,107Y09M
64000,64000250,64000250-011,954,2525,1303,1222,107Y09M
64000,64000250,64000250-004,914,2625,1360,1265,107Y09M
64000,64000250,64000250-003,351,889,479,410,107Y09M
64000,64000250,64000250-010,482,1321,677,644,107Y09M
64000,64000250,64000250-007,414,1105,564,541,107Y09M
64000,64000250,64000250-013,290,770,407,363,107Y09M
64000,64000250,64000250-001,445,1248,644,604,107Y09M
64000,64000250,64000250-009,685,2046,1033,1013,107Y09M
64000,64000250,64000250-008,1547,4324,2207,2117,107Y09M
64000,64000250,64000250-014,1294,3133,1523,1610,107Y09M
64000,64000250,64000250-012,506,1292,693,599,107Y09M
64000,64000250,64000250-005,1087,3156,1622,1534,107Y09M
64000,64000250,64000250-002,423,1143,610,533,107Y09M
64000,64000060,64000060-025,537,1184,550,634,107Y09M
64000,64000060,64000060-023,1549,3193,1576,1617,107Y09M
64000,64000060,64000060-007,567,1094,496,598,107Y09M
64000,64000060,64000060-014,1326,3230,1528,1702,107Y09M
64000,64000060,64000060-005,700,1517,710,807,107Y09M
64000,64000060,64000060-011,676,1478,701,777,107Y09M
64000,64000060,64000060-012,432,887,463,424,107Y09M
64000,64000060,64000060-015,1142,2841,1347,1494,107Y09M
64000,64000060,64000060-018,672,1388,661,727,107Y09M
64000,64000060,64000060-024,373,781,391,390,107Y09M
64000,64000060,64000060-032,633,1349,664,685,107Y09M
64000,64000060,64000060-027,514,1054,504,550,107Y09M
64000,64000060,64000060-022,970,2147,1080,1067,107Y09M
64000,64000060,64000060-029,441,895,443,452,107Y09M
64000,64000060,64000060-028,485,1030,522,508,107Y09M
64000,64000060,64000060-026,501,936,470,466,107Y09M
64000,64000060,64000060-002,589,1167,553,614,107Y09M
64000,64000060,64000060-004,542,1202,559,643,107Y09M
64000,64000060,64000060-001,958,1966,928,1038,107Y09M
64000,64000060,64000060-009,486,1086,537,549,107Y09M
64000,64000060,64000060-017,1592,4080,1905,2175,107Y09M
64000,64000060,64000060-013,944,2328,1142,1186,107Y09M
64000,64000060,64000060-021,564,1126,518,608,107Y09M
64000,64000060,64000060-019,573,1245,612,633,107Y09M
64000,64000060,64000060-031,354,837,403,434,107Y09M
64000,64000060,64000060-030,366,779,375,404,107Y09M
64000,64000060,64000060-003,1535,3461,1592,1869,107Y09M
64000,64000060,64000060-006,350,741,360,381,107Y09M
64000,64000060,64000060-008,970,2180,1049,1131,107Y09M
64000,64000060,64000060-020,445,949,479,470,107Y09M
64000,64000060,64000060-016,810,1966,922,1044,107Y09M
64000,64000060,64000060-010,363,833,437,396,107Y09M
64000,64000040,64000040-019,1260,3255,1595,1660,107Y09M
64000,64000040,64000040-020,937,2520,1223,1297,107Y09M
64000,64000040,64000040-037,1609,3831,1901,1930,107Y09M
64000,64000040,64000040-005,1590,3808,1890,1918,107Y09M
64000,64000040,64000040-036,646,1927,967,960,107Y09M
64000,64000040,64000040-003,2843,7335,3589,3746,107Y09M
64000,64000040,64000040-034,2585,6179,2925,3254,107Y09M
64000,64000040,64000040-033,3983,10152,4869,5283,107Y09M
64000,64000040,64000040-010,836,2518,1280,1238,107Y09M
64000,64000040,64000040-026,1490,3922,1873,2049,107Y09M
64000,64000040,64000040-015,432,985,503,482,107Y09M
64000,64000040,64000040-017,1153,3296,1658,1638,107Y09M
64000,64000040,64000040-016,992,2994,1486,1508,107Y09M
64000,64000040,64000040-030,985,2515,1222,1293,107Y09M
64000,64000040,64000040-004,1421,3622,1712,1910,107Y09M
64000,64000040,64000040-027,929,2294,1114,1180,107Y09M
64000,64000040,64000040-002,1925,5102,2433,2669,107Y09M
64000,64000040,64000040-011,1512,3858,1898,1960,107Y09M
64000,64000040,64000040-025,1214,3052,1499,1553,107Y09M
64000,64000040,64000040-023,629,1706,876,830,107Y09M
64000,64000040,64000040-032,1452,4207,2099,2108,107Y09M
64000,64000040,64000040-001,9919,26538,13059,13479,107Y09M
64000,64000040,64000040-022,2181,6466,3194,3272,107Y09M
64000,64000040,64000040-007,1753,4579,2252,2327,107Y09M
64000,64000040,64000040-006,1702,3528,1844,1684,107Y09M
64000,64000040,64000040-008,2351,5489,2647,2842,107Y09M
64000,64000040,64000040-029,1516,3871,1909,1962,107Y09M
64000,64000040,64000040-013,1666,4219,2048,2171,107Y09M
64000,64000040,64000040-012,620,1628,826,802,107Y09M
64000,64000040,64000040-031,2101,5645,2738,2907,107Y09M
64000,64000040,64000040-021,834,2337,1204,1133,107Y09M
64000,64000040,64000040-014,7487,17965,8723,9242,107Y09M
64000,64000040,64000040-018,1251,3440,1673,1767,107Y09M
64000,64000040,64000040-028,1392,3574,1755,1819,107Y09M
64000,64000040,64000040-024,1836,5151,2558,2593,107Y09M
64000,64000040,64000040-009,1202,3376,1683,1693,107Y09M
64000,64000040,64000040-035,3633,8287,4090,4197,107Y09M
64000,64000240,64000240-015,330,996,502,494,107Y09M
64000,64000240,64000240-009,927,3075,1619,1456,107Y09M
64000,64000240,64000240-013,1181,3856,1925,1931,107Y09M
64000,64000240,64000240-014,914,2968,1498,1470,107Y09M
64000,64000240,64000240-005,497,1487,761,726,107Y09M
64000,64000240,64000240-007,749,2469,1268,1201,107Y09M
64000,64000240,64000240-008,1198,3929,2051,1878,107Y09M
64000,64000240,64000240-012,883,2784,1432,1352,107Y09M
64000,64000240,64000240-011,1431,4372,2197,2175,107Y09M
64000,64000240,64000240-019,1219,3411,1668,1743,107Y09M
64000,64000240,64000240-010,644,2068,1106,962,107Y09M
64000,64000240,64000240-001,1194,3915,1950,1965,107Y09M
64000,64000240,64000240-018,352,969,510,459,107Y09M
64000,64000240,64000240-006,981,2671,1361,1310,107Y09M
64000,64000240,64000240-017,693,1945,1004,941,107Y09M
64000,64000240,64000240-020,1857,5081,2566,2515,107Y09M
64000,64000240,64000240-004,399,1321,686,635,107Y09M
64000,64000240,64000240-002,457,1419,725,694,107Y09M
64000,64000240,64000240-003,461,1441,752,689,107Y09M
64000,64000240,64000240-016,774,2376,1238,1138,107Y09M
64000,64000020,64000020-026,703,1502,744,758,107Y09M
64000,64000020,64000020-006,488,1218,648,570,107Y09M
64000,64000020,64000020-012,1526,3939,1930,2009,107Y09M
64000,64000020,64000020-011,886,2266,1133,1133,107Y09M
64000,64000020,64000020-013,1123,2939,1455,1484,107Y09M
64000,64000020,64000020-005,556,1432,724,708,107Y09M
64000,64000020,64000020-025,609,1366,678,688,107Y09M
64000,64000020,64000020-004,1453,3812,1967,1845,107Y09M
64000,64000020,64000020-009,339,778,401,377,107Y09M
64000,64000020,64000020-033,345,867,437,430,107Y09M
64000,64000020,64000020-008,1683,4187,2037,2150,107Y09M
64000,64000020,64000020-017,8482,20623,9571,11052,107Y09M
64000,64000020,64000020-027,647,1548,784,764,107Y09M
64000,64000020,64000020-003,1926,4569,2277,2292,107Y09M
64000,64000020,64000020-014,1445,3452,1732,1720,107Y09M
64000,64000020,64000020-007,1044,2785,1444,1341,107Y09M
64000,64000020,64000020-037,488,1156,609,547,107Y09M
64000,64000020,64000020-030,407,934,495,439,107Y09M
64000,64000020,64000020-038,283,631,355,276,107Y09M
64000,64000020,64000020-035,517,1279,683,596,107Y09M
64000,64000020,64000020-029,326,668,371,297,107Y09M
64000,64000020,64000020-018,1871,4373,2084,2289,107Y09M
64000,64000020,64000020-002,1008,2192,1062,1130,107Y09M
64000,64000020,64000020-032,453,1106,565,541,107Y09M
64000,64000020,64000020-019,1497,3564,1756,1808,107Y09M
64000,64000020,64000020-020,1199,2807,1385,1422,107Y09M
64000,64000020,64000020-021,562,1312,673,639,107Y09M
64000,64000020,64000020-001,940,2145,1032,1113,107Y09M
64000,64000020,64000020-036,602,1533,785,748,107Y09M
64000,64000020,64000020-028,666,1627,853,774,107Y09M
64000,64000020,64000020-034,559,1378,680,698,107Y09M
64000,64000020,64000020-022,478,1283,656,627,107Y09M
64000,64000020,64000020-024,628,1405,732,673,107Y09M
64000,64000020,64000020-015,8358,20066,9239,10827,107Y09M
64000,64000020,64000020-010,567,1360,703,657,107Y09M
64000,64000020,64000020-016,12484,28651,12990,15661,107Y09M
64000,64000020,64000020-031,467,1083,555,528,107Y09M
64000,64000020,64000020-023,1128,1954,1134,820,107Y09M
64000,64000300,64000300-016,959,2553,1338,1215,107Y09M
64000,64000300,64000300-007,445,1141,607,534,107Y09M
64000,64000300,64000300-018,530,1428,763,665,107Y09M
64000,64000300,64000300-006,561,1548,838,710,107Y09M
64000,64000300,64000300-002,1050,2751,1341,1410,107Y09M
64000,64000300,64000300-005,569,1684,914,770,107Y09M
64000,64000300,64000300-019,375,922,501,421,107Y09M
64000,64000300,64000300-010,90,185,106,79,107Y09M
64000,64000300,64000300-001,945,2593,1295,1298,107Y09M
64000,64000300,64000300-015,1398,4058,2035,2023,107Y09M
64000,64000300,64000300-013,717,1831,941,890,107Y09M
64000,64000300,64000300-011,854,2237,1149,1088,107Y09M
64000,64000300,64000300-012,454,1154,584,570,107Y09M
64000,64000300,64000300-020,569,1429,745,684,107Y09M
64000,64000300,64000300-009,866,2402,1277,1125,107Y09M
64000,64000300,64000300-003,806,1921,974,947,107Y09M
64000,64000300,64000300-004,736,2063,1059,1004,107Y09M
64000,64000300,64000300-008,347,882,488,394,107Y09M
64000,64000300,64000300-014,839,2390,1165,1225,107Y09M
64000,64000300,64000300-021,286,730,397,333,107Y09M
64000,64000300,64000300-017,325,811,452,359,107Y09M
64000,64000100,64000100-010,1380,3249,1690,1559,107Y09M
64000,64000100,64000100-011,939,2080,1075,1005,107Y09M
64000,64000100,64000100-006,634,1823,890,933,107Y09M
64000,64000100,64000100-013,1072,2910,1447,1463,107Y09M
64000,64000100,64000100-008,1187,3100,1642,1458,107Y09M
64000,64000100,64000100-002,489,1264,660,604,107Y09M
64000,64000100,64000100-012,471,1011,548,463,107Y09M
64000,64000100,64000100-009,945,2270,1203,1067,107Y09M
64000,64000100,64000100-003,705,1861,981,880,107Y09M
64000,64000100,64000100-005,1244,3410,1725,1685,107Y09M
64000,64000100,64000100-004,928,2658,1345,1313,107Y09M
64000,64000100,64000100-007,610,1564,778,786,107Y09M
64000,64000100,64000100-001,493,1326,695,631,107Y09M
64000,64000120,64000120-028,1473,3732,1839,1893,107Y09M
64000,64000120,64000120-072,1943,5504,2756,2748,107Y09M
64000,64000120,64000120-051,459,1176,572,604,107Y09M
64000,64000120,64000120-057,1895,5289,2602,2687,107Y09M
64000,64000120,64000120-015,1997,4777,2232,2545,107Y09M
64000,64000120,64000120-071,2082,4944,2406,2538,107Y09M
64000,64000120,64000120-008,1575,3869,1914,1955,107Y09M
64000,64000120,64000120-069,1210,2815,1384,1431,107Y09M
64000,64000120,64000120-070,2101,5039,2526,2513,107Y09M
64000,64000120,64000120-043,1392,3657,1799,1858,107Y09M
64000,64000120,64000120-032,1523,4031,1979,2052,107Y09M
64000,64000120,64000120-048,2875,7160,3594,3566,107Y09M
64000,64000120,64000120-011,1653,4084,1980,2104,107Y09M
64000,64000120,64000120-056,3931,10311,4887,5424,107Y09M
64000,64000120,64000120-060,4524,11523,5503,6020,107Y09M
64000,64000120,64000120-039,4363,10095,4777,5318,107Y09M
64000,64000120,64000120-059,2015,4692,2235,2457,107Y09M
64000,64000120,64000120-053,1824,4860,2429,2431,107Y09M
64000,64000120,64000120-027,2790,7141,3537,3604,107Y09M
64000,64000120,64000120-045,938,2363,1153,1210,107Y09M
64000,64000120,64000120-003,642,1477,740,737,107Y09M
64000,64000120,64000120-002,326,697,346,351,107Y09M
64000,64000120,64000120-017,3022,7821,3916,3905,107Y09M
64000,64000120,64000120-047,1584,4026,1961,2065,107Y09M
64000,64000120,64000120-006,1012,2660,1261,1399,107Y09M
64000,64000120,64000120-046,2229,6230,3052,3178,107Y09M
64000,64000120,64000120-044,2647,6632,3184,3448,107Y09M
64000,64000120,64000120-019,2125,5306,2540,2766,107Y09M
64000,64000120,64000120-024,1560,3975,1965,2010,107Y09M
64000,64000120,64000120-030,2647,6365,3056,3309,107Y09M
64000,64000120,64000120-058,1243,3015,1515,1500,107Y09M
64000,64000120,64000120-026,2162,5552,2729,2823,107Y09M
64000,64000120,64000120-064,1053,2709,1328,1381,107Y09M
64000,64000120,64000120-078,2990,8511,4123,4388,107Y09M
64000,64000120,64000120-055,3602,10014,4972,5042,107Y09M
64000,64000120,64000120-076,1201,3146,1537,1609,107Y09M
64000,64000120,64000120-005,472,1062,540,522,107Y09M
64000,64000120,64000120-022,1283,3456,1687,1769,107Y09M
64000,64000120,64000120-065,1714,4523,2155,2368,107Y09M
64000,64000120,64000120-037,1539,3699,1797,1902,107Y09M
64000,64000120,64000120-034,1817,4259,2083,2176,107Y09M
64000,64000120,64000120-063,1168,2948,1416,1532,107Y09M
64000,64000120,64000120-038,1218,2786,1382,1404,107Y09M
64000,64000120,64000120-014,2735,7201,3506,3695,107Y09M
64000,64000120,64000120-041,926,2204,1068,1136,107Y09M
64000,64000120,64000120-054,1364,2838,1545,1293,107Y09M
64000,64000120,64000120-074,1053,2908,1466,1442,107Y09M
64000,64000120,64000120-075,2487,6184,3018,3166,107Y09M
64000,64000120,64000120-025,1272,3533,1740,1793,107Y09M
64000,64000120,64000120-066,1037,2724,1345,1379,107Y09M
64000,64000120,64000120-068,1838,5037,2439,2598,107Y09M
64000,64000120,64000120-033,2322,6550,3200,3350,107Y09M
64000,64000120,64000120-036,1831,4802,2368,2434,107Y09M
64000,64000120,64000120-067,1856,5175,2512,2663,107Y09M
64000,64000120,64000120-021,1645,2784,1610,1174,107Y09M
64000,64000120,64000120-018,2293,6095,2978,3117,107Y09M
64000,64000120,64000120-031,2207,5850,2786,3064,107Y09M
64000,64000120,64000120-061,981,2418,1165,1253,107Y09M
64000,64000120,64000120-062,1270,3077,1495,1582,107Y09M
64000,64000120,64000120-020,1703,4282,2150,2132,107Y09M
64000,64000120,64000120-050,1197,2993,1412,1581,107Y09M
64000,64000120,64000120-040,6554,16216,8144,8072,107Y09M
64000,64000120,64000120-077,1246,3342,1650,1692,107Y09M
64000,64000120,64000120-049,2167,5350,2527,2823,107Y09M
64000,64000120,64000120-029,2555,7081,3453,3628,107Y09M
64000,64000120,64000120-035,2736,7464,3637,3827,107Y09M
64000,64000120,64000120-007,543,1254,596,658,107Y09M
64000,64000120,64000120-001,225,481,236,245,107Y09M
64000,64000120,64000120-010,408,944,465,479,107Y09M
64000,64000120,64000120-004,405,1054,496,558,107Y09M
64000,64000120,64000120-042,1599,4141,2003,2138,107Y09M
64000,64000120,64000120-073,1300,3251,1627,1624,107Y09M
64000,64000120,64000120-009,4386,9804,4765,5039,107Y09M
64000,64000120,64000120-012,2275,5731,2846,2885,107Y09M
64000,64000120,64000120-013,1231,2893,1436,1457,107Y09M
64000,64000120,64000120-016,2260,5412,2740,2672,107Y09M
64000,64000200,64000200-017,300,912,468,444,107Y09M
64000,64000200,64000200-014,277,748,407,341,107Y09M
64000,64000200,64000200-015,1486,4286,2112,2174,107Y09M
64000,64000200,64000200-003,988,2699,1375,1324,107Y09M
64000,64000200,64000200-004,1073,2860,1436,1424,107Y09M
64000,64000200,64000200-011,823,2246,1168,1078,107Y09M
64000,64000200,64000200-012,993,2735,1426,1309,107Y09M
64000,64000200,64000200-008,1455,3929,1939,1990,107Y09M
64000,64000200,64000200-007,555,1606,824,782,107Y09M
64000,64000200,64000200-005,461,1365,730,635,107Y09M
64000,64000200,64000200-006,906,2754,1381,1373,107Y09M
64000,64000200,64000200-013,584,1492,766,726,107Y09M
64000,64000200,64000200-009,599,1797,936,861,107Y09M
64000,64000200,64000200-010,1187,2779,1362,1417,107Y09M
64000,64000200,64000200-016,597,1678,862,816,107Y09M
64000,64000200,64000200-002,515,1266,650,616,107Y09M
64000,64000200,64000200-001,983,2499,1243,1256,107Y09M
64000,64000210,64000210-003,1250,3866,2141,1725,107Y09M
64000,64000210,64000210-001,462,1276,651,625,107Y09M
64000,64000210,64000210-009,1350,3943,2008,1935,107Y09M
64000,64000210,64000210-004,1089,3033,1597,1436,107Y09M
64000,64000210,64000210-007,853,2720,1387,1333,107Y09M
64000,64000210,64000210-006,205,540,305,235,107Y09M
64000,64000210,64000210-008,1676,4409,2299,2110,107Y09M
64000,64000210,64000210-011,1025,2774,1408,1366,107Y09M
64000,64000210,64000210-005,1001,2728,1421,1307,107Y09M
64000,64000210,64000210-010,847,2078,1193,885,107Y09M
64000,64000210,64000210-002,841,2428,1264,1164,107Y09M
64000,64000280,64000280-007,773,1978,1043,935,107Y09M
64000,64000280,64000280-001,520,1491,744,747,107Y09M
64000,64000280,64000280-012,779,2403,1227,1176,107Y09M
64000,64000280,64000280-010,345,1007,520,487,107Y09M
64000,64000280,64000280-009,394,1079,552,527,107Y09M
64000,64000280,64000280-011,449,1380,682,698,107Y09M
64000,64000280,64000280-003,240,615,321,294,107Y09M
64000,64000280,64000280-005,702,2066,1048,1018,107Y09M
64000,64000280,64000280-002,762,2196,1070,1126,107Y09M
64000,64000280,64000280-004,294,848,412,436,107Y09M
64000,64000280,64000280-006,691,1846,999,847,107Y09M
64000,64000280,64000280-008,844,2376,1276,1100,107Y09M
64000,64000010,64000010-005,503,1160,550,610,107Y09M
64000,64000010,64000010-008,295,685,317,368,107Y09M
64000,64000010,64000010-009,790,1521,758,763,107Y09M
64000,64000010,64000010-015,500,1172,608,564,107Y09M
64000,64000010,64000010-021,278,714,361,353,107Y09M
64000,64000010,64000010-012,305,838,421,417,107Y09M
64000,64000010,64000010-010,392,877,412,465,107Y09M
64000,64000010,64000010-017,1154,2179,1140,1039,107Y09M
64000,64000010,64000010-011,779,1825,893,932,107Y09M
64000,64000010,64000010-013,480,1090,550,540,107Y09M
64000,64000010,64000010-006,965,2254,1111,1143,107Y09M
64000,64000010,64000010-018,553,1310,636,674,107Y09M
64000,64000010,64000010-003,335,717,342,375,107Y09M
64000,64000010,64000010-014,545,1218,594,624,107Y09M
64000,64000010,64000010-002,164,403,203,200,107Y09M
64000,64000010,64000010-020,277,669,339,330,107Y09M
64000,64000010,64000010-007,389,926,479,447,107Y09M
64000,64000010,64000010-016,449,953,466,487,107Y09M
64000,64000010,64000010-004,723,1452,748,704,107Y09M
64000,64000010,64000010-001,616,1500,720,780,107Y09M
64000,64000010,64000010-019,305,645,319,326,107Y09M
10017,10017020,10017020-006,664,1770,864,906,107Y09M
10017,10017020,10017020-008,1086,2563,1343,1220,107Y09M
10017,10017020,10017020-015,979,2040,1044,996,107Y09M
10017,10017020,10017020-016,275,498,280,218,107Y09M
10017,10017020,10017020-002,1281,2899,1436,1463,107Y09M
10017,10017020,10017020-017,926,2300,1119,1181,107Y09M
10017,10017020,10017020-004,940,2210,1045,1165,107Y09M
10017,10017020,10017020-005,1039,2560,1282,1278,107Y09M
10017,10017020,10017020-018,2661,7209,3585,3624,107Y09M
10017,10017020,10017020-007,516,1260,668,592,107Y09M
10017,10017020,10017020-020,1104,2863,1478,1385,107Y09M
10017,10017020,10017020-001,1684,4350,2183,2167,107Y09M
10017,10017020,10017020-009,2073,4941,2497,2444,107Y09M
10017,10017020,10017020-010,1548,4133,2064,2069,107Y09M
10017,10017020,10017020-011,944,2419,1239,1180,107Y09M
10017,10017020,10017020-003,1653,4129,2055,2074,107Y09M
10017,10017020,10017020-019,1694,4466,2173,2293,107Y09M
10017,10017020,10017020-014,173,385,204,181,107Y09M
10017,10017020,10017020-013,178,348,197,151,107Y09M
10017,10017020,10017020-012,179,499,284,215,107Y09M
10017,10017050,10017050-004,445,1054,543,511,107Y09M
10017,10017050,10017050-021,2512,6406,3163,3243,107Y09M
10017,10017050,10017050-006,638,1433,716,717,107Y09M
10017,10017050,10017050-007,342,860,456,404,107Y09M
10017,10017050,10017050-015,403,994,517,477,107Y09M
10017,10017050,10017050-013,725,1473,830,643,107Y09M
10017,10017050,10017050-014,283,668,380,288,107Y09M
10017,10017050,10017050-005,380,869,426,443,107Y09M
10017,10017050,10017050-003,344,841,416,425,107Y09M
10017,10017050,10017050-002,503,1129,576,553,107Y09M
10017,10017050,10017050-018,425,1045,530,515,107Y09M
10017,10017050,10017050-019,753,1816,914,902,107Y09M
10017,10017050,10017050-017,428,945,481,464,107Y09M
10017,10017050,10017050-016,343,777,401,376,107Y09M
10017,10017050,10017050-012,692,1785,948,837,107Y09M
10017,10017050,10017050-023,237,499,276,223,107Y09M
10017,10017050,10017050-024,2876,7617,3822,3795,107Y09M
10017,10017050,10017050-010,637,1479,746,733,107Y09M
10017,10017050,10017050-008,584,1295,669,626,107Y09M
10017,10017050,10017050-009,489,1093,555,538,107Y09M
10017,10017050,10017050-011,790,1992,1029,963,107Y09M
10017,10017050,10017050-001,419,859,447,412,107Y09M
10017,10017050,10017050-022,1685,4359,2173,2186,107Y09M
10017,10017050,10017050-020,2356,6172,3033,3139,107Y09M
10017,10017010,10017010-008,407,917,452,465,107Y09M
10017,10017010,10017010-019,641,1662,908,754,107Y09M
10017,10017010,10017010-023,804,1860,953,907,107Y09M
10017,10017010,10017010-009,968,1736,930,806,107Y09M
10017,10017010,10017010-006,583,1347,666,681,107Y09M
10017,10017010,10017010-014,605,1404,748,656,107Y09M
10017,10017010,10017010-018,584,1422,763,659,107Y09M
10017,10017010,10017010-010,1162,2564,1301,1263,107Y09M
10017,10017010,10017010-007,650,1412,740,672,107Y09M
10017,10017010,10017010-002,627,1342,704,638,107Y09M
10017,10017010,10017010-024,481,1062,554,508,107Y09M
10017,10017010,10017010-017,470,1131,578,553,107Y09M
10017,10017010,10017010-016,795,2019,1056,963,107Y09M
10017,10017010,10017010-021,206,520,269,251,107Y09M
10017,10017010,10017010-003,463,997,500,497,107Y09M
10017,10017010,10017010-013,908,2223,1179,1044,107Y09M
10017,10017010,10017010-022,2749,6109,3146,2963,107Y09M
10017,10017010,10017010-012,962,2238,1131,1107,107Y09M
10017,10017010,10017010-015,535,1317,680,637,107Y09M
10017,10017010,10017010-011,638,1473,742,731,107Y09M
10017,10017010,10017010-005,668,1351,665,686,107Y09M
10017,10017010,10017010-026,2241,5823,2952,2871,107Y09M
10017,10017010,10017010-025,3061,6414,3055,3359,107Y09M
10017,10017010,10017010-004,497,1166,571,595,107Y09M
10017,10017010,10017010-020,591,1425,748,677,107Y09M
10017,10017010,10017010-001,403,800,393,407,107Y09M
10017,10017040,10017040-009,493,1023,506,517,107Y09M
10017,10017040,10017040-020,465,918,457,461,107Y09M
10017,10017040,10017040-027,415,795,430,365,107Y09M
10017,10017040,10017040-004,987,2436,1152,1284,107Y09M
10017,10017040,10017040-008,558,1300,652,648,107Y09M
10017,10017040,10017040-029,1310,2819,1444,1375,107Y09M
10017,10017040,10017040-021,375,820,406,414,107Y09M
10017,10017040,10017040-013,1279,2871,1463,1408,107Y09M
10017,10017040,10017040-026,302,606,319,287,107Y09M
10017,10017040,10017040-018,426,917,460,457,107Y09M
10017,10017040,10017040-014,333,868,464,404,107Y09M
10017,10017040,10017040-006,1013,2430,1122,1308,107Y09M
10017,10017040,10017040-007,478,1161,560,601,107Y09M
10017,10017040,10017040-025,400,758,381,377,107Y09M
10017,10017040,10017040-001,926,2381,1152,1229,107Y09M
10017,10017040,10017040-002,578,1468,684,784,107Y09M
10017,10017040,10017040-015,645,1450,753,697,107Y09M
10017,10017040,10017040-003,862,2176,1018,1158,107Y09M
10017,10017040,10017040-023,469,1209,623,586,107Y09M
10017,10017040,10017040-019,500,949,475,474,107Y09M
10017,10017040,10017040-010,734,1718,846,872,107Y09M
10017,10017040,10017040-005,1325,3324,1559,1765,107Y09M
10017,10017040,10017040-024,1370,3154,1515,1639,107Y09M
10017,10017040,10017040-028,341,651,324,327,107Y09M
10017,10017040,10017040-022,482,1115,589,526,107Y09M
10017,10017040,10017040-012,469,1054,533,521,107Y09M
10017,10017040,10017040-011,373,817,423,394,107Y09M
10017,10017040,10017040-017,853,1929,983,946,107Y09M
10017,10017040,10017040-016,383,853,463,390,107Y09M
10017,10017060,10017060-019,1204,3022,1481,1541,107Y09M
10017,10017060,10017060-015,1333,3004,1474,1530,107Y09M
10017,10017060,10017060-006,859,2332,1180,1152,107Y09M
10017,10017060,10017060-012,747,1904,983,921,107Y09M
10017,10017060,10017060-017,1606,3988,1942,2046,107Y09M
10017,10017060,10017060-013,2475,6064,3115,2949,107Y09M
10017,10017060,10017060-018,1757,4507,2176,2331,107Y09M
10017,10017060,10017060-016,2105,5686,2835,2851,107Y09M
10017,10017060,10017060-011,1841,4588,2296,2292,107Y09M
10017,10017060,10017060-007,847,2230,1117,1113,107Y09M
10017,10017060,10017060-009,397,969,459,510,107Y09M
10017,10017060,10017060-001,561,1353,700,653,107Y09M
10017,10017060,10017060-025,2197,5282,2546,2736,107Y09M
10017,10017060,10017060-004,505,1154,575,579,107Y09M
10017,10017060,10017060-002,469,1154,603,551,107Y09M
10017,10017060,10017060-021,2112,5409,2667,2742,107Y09M
10017,10017060,10017060-022,1582,3838,1809,2029,107Y09M
10017,10017060,10017060-005,417,1037,524,513,107Y09M
10017,10017060,10017060-003,623,1529,820,709,107Y09M
10017,10017060,10017060-014,1814,4706,2349,2357,107Y09M
10017,10017060,10017060-008,1503,3618,1850,1768,107Y09M
10017,10017060,10017060-010,280,638,312,326,107Y09M
10017,10017060,10017060-023,2271,5462,2681,2781,107Y09M
10017,10017060,10017060-024,2535,5387,2420,2967,107Y09M
10017,10017060,10017060-020,1571,3408,1794,1614,107Y09M
10017,10017070,10017070-002,599,1346,645,701,107Y09M
10017,10017070,10017070-001,570,1334,625,709,107Y09M
10017,10017070,10017070-015,572,1527,783,744,107Y09M
10017,10017070,10017070-020,3300,8637,4225,4412,107Y09M
10017,10017070,10017070-017,1740,4377,2179,2198,107Y09M
10017,10017070,10017070-019,1097,2907,1468,1439,107Y09M
10017,10017070,10017070-018,1583,3970,1874,2096,107Y09M
10017,10017070,10017070-012,811,1920,961,959,107Y09M
10017,10017070,10017070-014,1311,3107,1525,1582,107Y09M
10017,10017070,10017070-013,1632,3956,1958,1998,107Y09M
10017,10017070,10017070-016,1914,4681,2357,2324,107Y09M
10017,10017070,10017070-011,1001,2396,1183,1213,107Y09M
10017,10017070,10017070-008,706,1707,880,827,107Y09M
10017,10017070,10017070-007,376,811,386,425,107Y09M
10017,10017070,10017070-005,342,788,390,398,107Y09M
10017,10017070,10017070-006,821,1657,868,789,107Y09M
10017,10017070,10017070-004,1114,2541,1243,1298,107Y09M
10017,10017070,10017070-003,615,1342,642,700,107Y09M
10017,10017070,10017070-010,728,1676,794,882,107Y09M
10017,10017070,10017070-009,797,1783,874,909,107Y09M
10017,10017030,10017030-011,223,514,296,218,107Y09M
10017,10017030,10017030-001,662,1642,823,819,107Y09M
10017,10017030,10017030-003,356,825,419,406,107Y09M
10017,10017030,10017030-002,300,715,372,343,107Y09M
10017,10017030,10017030-007,1225,2883,1484,1399,107Y09M
10017,10017030,10017030-010,2127,5373,2707,2666,107Y09M
10017,10017030,10017030-009,187,478,269,209,107Y09M
10017,10017030,10017030-008,1186,3064,1512,1552,107Y09M
10017,10017030,10017030-004,1695,4203,2122,2081,107Y09M
10017,10017030,10017030-005,1251,3106,1503,1603,107Y09M
10017,10017030,10017030-012,2285,5710,2792,2918,107Y09M
10017,10017030,10017030-006,1352,3359,1684,1675,107Y09M
10017,10017030,10017030-013,2867,6758,3362,3396,107Y09M
9007,9007020,09007020-005,83,319,167,152,107Y09M
9007,9007020,09007020-006,46,154,100,54,107Y09M
9007,9007020,09007020-002,56,206,116,90,107Y09M
9007,9007020,09007020-004,74,212,110,102,107Y09M
9007,9007020,09007020-001,283,1130,627,503,107Y09M
9007,9007020,09007020-003,90,401,234,167,107Y09M
9007,9007040,09007040-001,163,651,372,279,107Y09M
9007,9007040,09007040-002,174,699,431,268,107Y09M
9007,9007010,09007010-005,134,554,301,253,107Y09M
9007,9007010,09007010-001,611,2374,1288,1086,107Y09M
9007,9007010,09007010-009,32,165,94,71,107Y09M
9007,9007010,09007010-006,96,440,268,172,107Y09M
9007,9007010,09007010-008,34,238,142,96,107Y09M
9007,9007010,09007010-007,120,608,346,262,107Y09M
9007,9007010,09007010-004,289,1127,629,498,107Y09M
9007,9007010,09007010-002,230,1229,698,531,107Y09M
9007,9007010,09007010-003,211,919,543,376,107Y09M
9007,9007030,09007030-005,105,580,344,236,107Y09M
9007,9007030,09007030-002,39,212,137,75,107Y09M
9007,9007030,09007030-003,23,73,46,27,107Y09M
9007,9007030,09007030-001,81,488,305,183,107Y09M
9007,9007030,09007030-004,47,279,164,115,107Y09M
10009,10009110,10009110-004,572,1651,909,742,107Y09M
10009,10009110,10009110-016,329,996,518,478,107Y09M
10009,10009110,10009110-014,482,1444,763,681,107Y09M
10009,10009110,10009110-008,332,1056,561,495,107Y09M
10009,10009110,10009110-012,348,992,527,465,107Y09M
10009,10009110,10009110-018,514,1630,866,764,107Y09M
10009,10009110,10009110-006,663,2125,1163,962,107Y09M
10009,10009110,10009110-015,375,1062,595,467,107Y09M
10009,10009110,10009110-003,626,1860,1026,834,107Y09M
10009,10009110,10009110-007,331,992,547,445,107Y09M
10009,10009110,10009110-013,687,2033,1052,981,107Y09M
10009,10009110,10009110-002,702,2065,1073,992,107Y09M
10009,10009110,10009110-001,617,1729,899,830,107Y09M
10009,10009110,10009110-017,380,1159,623,536,107Y09M
10009,10009110,10009110-011,724,2145,1155,990,107Y09M
10009,10009110,10009110-005,438,1311,721,590,107Y09M
10009,10009110,10009110-010,563,1788,958,830,107Y09M
10009,10009110,10009110-009,241,902,446,456,107Y09M
10009,10009190,10009190-008,795,2303,1257,1046,107Y09M
10009,10009190,10009190-002,437,1288,668,620,107Y09M
10009,10009190,10009190-017,346,1087,590,497,107Y09M
10009,10009190,10009190-014,710,2227,1137,1090,107Y09M
10009,10009190,10009190-015,360,1070,580,490,107Y09M
10009,10009190,10009190-011,212,603,320,283,107Y09M
10009,10009190,10009190-018,281,784,423,361,107Y09M
10009,10009190,10009190-004,342,1010,564,446,107Y09M
10009,10009190,10009190-005,273,798,418,380,107Y09M
10009,10009190,10009190-009,598,1784,955,829,107Y09M
10009,10009190,10009190-010,562,1676,900,776,107Y09M
10009,10009190,10009190-020,486,1354,744,610,107Y09M
10009,10009190,10009190-019,704,2058,1093,965,107Y09M
10009,10009190,10009190-007,572,1621,866,755,107Y09M
10009,10009190,10009190-003,275,732,409,323,107Y09M
10009,10009190,10009190-013,330,929,470,459,107Y09M
10009,10009190,10009190-012,617,1721,902,819,107Y09M
10009,10009190,10009190-016,366,1134,616,518,107Y09M
10009,10009190,10009190-001,512,1410,735,675,107Y09M
10009,10009190,10009190-021,259,684,378,306,107Y09M
10009,10009190,10009190-006,394,1137,584,553,107Y09M
10009,10009050,10009050-009,326,980,510,470,107Y09M
10009,10009050,10009050-013,302,1037,540,497,107Y09M
10009,10009050,10009050-010,1188,3567,1742,1825,107Y09M
10009,10009050,10009050-014,659,2074,1113,961,107Y09M
10009,10009050,10009050-001,358,959,490,469,107Y09M
10009,10009050,10009050-011,647,2159,1128,1031,107Y09M
10009,10009050,10009050-012,637,2083,1079,1004,107Y09M
10009,10009050,10009050-015,795,2662,1424,1238,107Y09M
10009,10009050,10009050-003,576,1653,819,834,107Y09M
10009,10009050,10009050-008,501,1412,782,630,107Y09M
10009,10009050,10009050-016,587,1749,912,837,107Y09M
10009,10009050,10009050-004,439,1233,652,581,107Y09M
10009,10009050,10009050-002,371,1088,588,500,107Y09M
10009,10009050,10009050-017,531,1662,872,790,107Y09M
10009,10009050,10009050-005,442,1295,673,622,107Y09M
10009,10009050,10009050-007,510,1499,824,675,107Y09M
10009,10009050,10009050-006,567,1722,894,828,107Y09M
10009,10009080,10009080-008,456,1383,767,616,107Y09M
10009,10009080,10009080-003,400,1181,670,511,107Y09M
10009,10009080,10009080-001,345,846,458,388,107Y09M
10009,10009080,10009080-013,269,794,427,367,107Y09M
10009,10009080,10009080-009,308,820,455,365,107Y09M
10009,10009080,10009080-015,303,803,465,338,107Y09M
10009,10009080,10009080-005,750,2189,1113,1076,107Y09M
10009,10009080,10009080-012,320,869,473,396,107Y09M
10009,10009080,10009080-004,368,1076,593,483,107Y09M
10009,10009080,10009080-002,818,2481,1279,1202,107Y09M
10009,10009080,10009080-006,692,2074,1074,1000,107Y09M
10009,10009080,10009080-014,282,818,443,375,107Y09M
10009,10009080,10009080-011,415,1257,699,558,107Y09M
10009,10009080,10009080-007,644,1836,943,893,107Y09M
10009,10009080,10009080-010,278,689,393,296,107Y09M
10009,10009170,10009170-013,619,1744,930,814,107Y09M
10009,10009170,10009170-003,527,1524,831,693,107Y09M
10009,10009170,10009170-005,377,1112,625,487,107Y09M
10009,10009170,10009170-007,391,1031,587,444,107Y09M
10009,10009170,10009170-019,249,679,374,305,107Y09M
10009,10009170,10009170-018,580,1726,943,783,107Y09M
10009,10009170,10009170-006,446,1251,682,569,107Y09M
10009,10009170,10009170-015,363,975,529,446,107Y09M
10009,10009170,10009170-011,154,396,235,161,107Y09M
10009,10009170,10009170-002,681,1726,969,757,107Y09M
10009,10009170,10009170-001,1360,3901,2082,1819,107Y09M
10009,10009170,10009170-010,316,961,507,454,107Y09M
10009,10009170,10009170-004,293,805,446,359,107Y09M
10009,10009170,10009170-020,325,949,532,417,107Y09M
10009,10009170,10009170-012,434,1307,701,606,107Y09M
10009,10009170,10009170-016,503,1336,733,603,107Y09M
10009,10009170,10009170-017,376,958,514,444,107Y09M
10009,10009170,10009170-021,257,798,434,364,107Y09M
10009,10009170,10009170-008,353,833,482,351,107Y09M
10009,10009170,10009170-009,242,663,360,303,107Y09M
10009,10009170,10009170-014,396,1142,628,514,107Y09M
10009,10009010,10009010-009,1250,3869,1936,1933,107Y09M
10009,10009010,10009010-031,428,1318,668,650,107Y09M
10009,10009010,10009010-008,2195,5921,2792,3129,107Y09M
10009,10009010,10009010-017,251,626,342,284,107Y09M
10009,10009010,10009010-020,946,2765,1433,1332,107Y09M
10009,10009010,10009010-006,354,888,461,427,107Y09M
10009,10009010,10009010-002,506,1332,646,686,107Y09M
10009,10009010,10009010-034,1373,3579,1670,1909,107Y09M
10009,10009010,10009010-036,1025,2717,1314,1403,107Y09M
10009,10009010,10009010-005,368,969,482,487,107Y09M
10009,10009010,10009010-039,1006,2878,1456,1422,107Y09M
10009,10009010,10009010-004,291,711,362,349,107Y09M
10009,10009010,10009010-007,398,870,429,441,107Y09M
10009,10009010,10009010-038,1111,3374,1630,1744,107Y09M
10009,10009010,10009010-016,910,2647,1288,1359,107Y09M
10009,10009010,10009010-001,683,1704,836,868,107Y09M
10009,10009010,10009010-037,1481,4412,2218,2194,107Y09M
10009,10009010,10009010-013,1692,4956,2510,2446,107Y09M
10009,10009010,10009010-035,1051,2726,1320,1406,107Y09M
10009,10009010,10009010-023,2209,6462,3256,3206,107Y09M
10009,10009010,10009010-021,673,2015,1044,971,107Y09M
10009,10009010,10009010-030,1132,3482,1762,1720,107Y09M
10009,10009010,10009010-003,319,738,370,368,107Y09M
10009,10009010,10009010-022,2219,6448,3199,3249,107Y09M
10009,10009010,10009010-014,913,2706,1365,1341,107Y09M
10009,10009010,10009010-018,1097,2850,1380,1470,107Y09M
10009,10009010,10009010-024,698,2099,1105,994,107Y09M
10009,10009010,10009010-025,444,1248,679,569,107Y09M
10009,10009010,10009010-015,272,769,398,371,107Y09M
10009,10009010,10009010-029,1271,3692,1901,1791,107Y09M
10009,10009010,10009010-019,613,1763,850,913,107Y09M
10009,10009010,10009010-026,1741,5269,2623,2646,107Y09M
10009,10009010,10009010-027,401,1281,705,576,107Y09M
10009,10009010,10009010-028,744,2348,1158,1190,107Y09M
10009,10009010,10009010-011,842,2149,1062,1087,107Y09M
10009,10009010,10009010-010,1199,3361,1653,1708,107Y09M
10009,10009010,10009010-033,1762,4441,2215,2226,107Y09M
10009,10009010,10009010-032,1041,2864,1384,1480,107Y09M
10009,10009010,10009010-012,1624,4240,1990,2250,107Y09M
10009,10009020,10009020-023,1237,3413,1630,1783,107Y09M
10009,10009020,10009020-017,387,1004,545,459,107Y09M
10009,10009020,10009020-021,605,1763,905,858,107Y09M
10009,10009020,10009020-005,562,1478,745,733,107Y09M
10009,10009020,10009020-004,619,1767,832,935,107Y09M
10009,10009020,10009020-015,851,2632,1400,1232,107Y09M
10009,10009020,10009020-022,331,984,531,453,107Y09M
10009,10009020,10009020-008,296,881,465,416,107Y09M
10009,10009020,10009020-019,342,984,534,450,107Y09M
10009,10009020,10009020-002,932,2546,1229,1317,107Y09M
10009,10009020,10009020-016,1420,3861,1891,1970,107Y09M
10009,10009020,10009020-001,494,1405,707,698,107Y09M
10009,10009020,10009020-013,386,1100,575,525,107Y09M
10009,10009020,10009020-007,527,1509,769,740,107Y09M
10009,10009020,10009020-011,437,1289,687,602,107Y09M
10009,10009020,10009020-003,1060,2631,1269,1362,107Y09M
10009,10009020,10009020-018,327,878,444,434,107Y09M
10009,10009020,10009020-012,699,1966,998,968,107Y09M
10009,10009020,10009020-014,1071,3166,1624,1542,107Y09M
10009,10009020,10009020-010,299,782,418,364,107Y09M
10009,10009020,10009020-020,608,1710,914,796,107Y09M
10009,10009020,10009020-009,345,977,554,423,107Y09M
10009,10009020,10009020-024,930,2697,1359,1338,107Y09M
10009,10009020,10009020-006,1147,3227,1657,1570,107Y09M
10009,10009200,10009200-021,303,764,445,319,107Y09M
10009,10009200,10009200-004,515,1344,715,629,107Y09M
10009,10009200,10009200-013,492,1222,658,564,107Y09M
10009,10009200,10009200-014,404,1101,602,499,107Y09M
10009,10009200,10009200-017,362,927,512,415,107Y09M
10009,10009200,10009200-001,967,2596,1368,1228,107Y09M
10009,10009200,10009200-002,876,2307,1223,1084,107Y09M
10009,10009200,10009200-012,279,728,403,325,107Y09M
10009,10009200,10009200-006,293,718,414,304,107Y09M
10009,10009200,10009200-007,272,678,377,301,107Y09M
10009,10009200,10009200-019,238,573,323,250,107Y09M
10009,10009200,10009200-018,469,1368,697,671,107Y09M
10009,10009200,10009200-020,300,735,398,337,107Y09M
10009,10009200,10009200-023,336,788,413,375,107Y09M
10009,10009200,10009200-005,404,1135,651,484,107Y09M
10009,10009200,10009200-003,424,1183,637,546,107Y09M
10009,10009200,10009200-015,340,937,527,410,107Y09M
10009,10009200,10009200-022,327,741,435,306,107Y09M
10009,10009200,10009200-024,328,878,469,409,107Y09M
10009,10009200,10009200-011,311,795,426,369,107Y09M
10009,10009200,10009200-016,421,1075,590,485,107Y09M
10009,10009200,10009200-008,471,1147,616,531,107Y09M
10009,10009200,10009200-010,446,1074,617,457,107Y09M
10009,10009200,10009200-009,288,676,364,312,107Y09M
10009,10009060,10009060-023,270,626,353,273,107Y09M
10009,10009060,10009060-012,630,1378,708,670,107Y09M
10009,10009060,10009060-005,173,373,202,171,107Y09M
10009,10009060,10009060-013,237,518,258,260,107Y09M
10009,10009060,10009060-009,274,576,295,281,107Y09M
10009,10009060,10009060-011,295,620,331,289,107Y09M
10009,10009060,10009060-027,222,546,303,243,107Y09M
10009,10009060,10009060-002,356,796,405,391,107Y09M
10009,10009060,10009060-015,901,2155,1051,1104,107Y09M
10009,10009060,10009060-007,232,460,247,213,107Y09M
10009,10009060,10009060-024,659,1852,1001,851,107Y09M
10009,10009060,10009060-008,521,1138,580,558,107Y09M
10009,10009060,10009060-026,389,1086,573,513,107Y09M
10009,10009060,10009060-018,334,919,478,441,107Y09M
10009,10009060,10009060-003,258,508,271,237,107Y09M
10009,10009060,10009060-001,396,880,469,411,107Y09M
10009,10009060,10009060-004,443,1052,548,504,107Y09M
10009,10009060,10009060-021,397,1118,622,496,107Y09M
10009,10009060,10009060-019,535,1599,839,760,107Y09M
10009,10009060,10009060-022,388,911,516,395,107Y09M
10009,10009060,10009060-014,2390,5850,3000,2850,107Y09M
10009,10009060,10009060-028,177,443,232,211,107Y09M
10009,10009060,10009060-016,2872,7590,3713,3877,107Y09M
10009,10009060,10009060-020,487,1320,740,580,107Y09M
10009,10009060,10009060-006,213,477,236,241,107Y09M
10009,10009060,10009060-017,464,1310,670,640,107Y09M
10009,10009060,10009060-010,173,389,205,184,107Y09M
10009,10009060,10009060-025,1379,3541,1804,1737,107Y09M
10009,10009070,10009070-001,471,1446,768,678,107Y09M
10009,10009070,10009070-017,929,2572,1346,1226,107Y09M
10009,10009070,10009070-010,884,2468,1242,1226,107Y09M
10009,10009070,10009070-015,821,2390,1279,1111,107Y09M
10009,10009070,10009070-002,415,1212,612,600,107Y09M
10009,10009070,10009070-019,660,1691,861,830,107Y09M
10009,10009070,10009070-005,1200,3641,1865,1776,107Y09M
10009,10009070,10009070-012,525,1391,721,670,107Y09M
10009,10009070,10009070-011,443,1273,686,587,107Y09M
10009,10009070,10009070-014,269,631,366,265,107Y09M
10009,10009070,10009070-003,444,1333,707,626,107Y09M
10009,10009070,10009070-004,553,1673,911,762,107Y09M
10009,10009070,10009070-016,295,802,435,367,107Y09M
10009,10009070,10009070-018,856,2439,1241,1198,107Y09M
10009,10009070,10009070-007,777,2415,1259,1156,107Y09M
10009,10009070,10009070-008,325,820,451,369,107Y09M
10009,10009070,10009070-009,118,312,185,127,107Y09M
10009,10009070,10009070-020,280,785,419,366,107Y09M
10009,10009070,10009070-006,575,1700,936,764,107Y09M
10009,10009070,10009070-013,196,496,284,212,107Y09M
10009,10009180,10009180-016,414,1027,548,479,107Y09M
10009,10009180,10009180-021,426,1194,629,565,107Y09M
10009,10009180,10009180-010,151,395,210,185,107Y09M
10009,10009180,10009180-011,324,872,507,365,107Y09M
10009,10009180,10009180-001,763,2000,1068,932,107Y09M
10009,10009180,10009180-012,402,1041,571,470,107Y09M
10009,10009180,10009180-018,405,1113,616,497,107Y09M
10009,10009180,10009180-017,469,1182,641,541,107Y09M
10009,10009180,10009180-006,518,1372,753,619,107Y09M
10009,10009180,10009180-009,363,972,518,454,107Y09M
10009,10009180,10009180-020,219,598,330,268,107Y09M
10009,10009180,10009180-013,687,1872,949,923,107Y09M
10009,10009180,10009180-014,347,850,459,391,107Y09M
10009,10009180,10009180-004,399,1019,568,451,107Y09M
10009,10009180,10009180-005,945,2613,1374,1239,107Y09M
10009,10009180,10009180-007,311,860,483,377,107Y09M
10009,10009180,10009180-002,254,734,407,327,107Y09M
10009,10009180,10009180-019,295,798,452,346,107Y09M
10009,10009180,10009180-003,380,1062,588,474,107Y09M
10009,10009180,10009180-015,312,782,418,364,107Y09M
10009,10009180,10009180-008,349,1019,570,449,107Y09M
10009,10009040,10009040-026,328,1048,541,507,107Y09M
10009,10009040,10009040-024,280,866,446,420,107Y09M
10009,10009040,10009040-023,285,995,529,466,107Y09M
10009,10009040,10009040-002,692,2086,1018,1068,107Y09M
10009,10009040,10009040-017,618,1962,1032,930,107Y09M
10009,10009040,10009040-006,273,686,339,347,107Y09M
10009,10009040,10009040-009,1179,3501,1721,1780,107Y09M
10009,10009040,10009040-027,468,1595,850,745,107Y09M
10009,10009040,10009040-004,1249,3593,1778,1815,107Y09M
10009,10009040,10009040-005,153,400,202,198,107Y09M
10009,10009040,10009040-008,476,1324,637,687,107Y09M
10009,10009040,10009040-015,639,2182,1116,1066,107Y09M
10009,10009040,10009040-025,463,1542,793,749,107Y09M
10009,10009040,10009040-019,367,1136,601,535,107Y09M
10009,10009040,10009040-014,421,1214,623,591,107Y09M
10009,10009040,10009040-001,591,1907,976,931,107Y09M
10009,10009040,10009040-018,278,1013,521,492,107Y09M
10009,10009040,10009040-022,362,1119,587,532,107Y09M
10009,10009040,10009040-021,561,1750,913,837,107Y09M
10009,10009040,10009040-013,392,1134,572,562,107Y09M
10009,10009040,10009040-011,434,1561,799,762,107Y09M
10009,10009040,10009040-012,534,1815,959,856,107Y09M
10009,10009040,10009040-010,1781,5490,2658,2832,107Y09M
10009,10009040,10009040-016,471,1768,925,843,107Y09M
10009,10009040,10009040-007,262,689,340,349,107Y09M
10009,10009040,10009040-003,911,2702,1299,1403,107Y09M
10009,10009040,10009040-020,349,1034,525,509,107Y09M
10009,10009140,10009140-005,508,1328,740,588,107Y09M
10009,10009140,10009140-012,458,1105,626,479,107Y09M
10009,10009140,10009140-010,841,2174,1221,953,107Y09M
10009,10009140,10009140-008,421,963,575,388,107Y09M
10009,10009140,10009140-009,335,944,537,407,107Y09M
10009,10009140,10009140-002,539,1392,727,665,107Y09M
10009,10009140,10009140-001,649,1773,909,864,107Y09M
10009,10009140,10009140-004,229,600,324,276,107Y09M
10009,10009140,10009140-006,235,610,328,282,107Y09M
10009,10009140,10009140-011,469,1210,668,542,107Y09M
10009,10009140,10009140-003,707,1863,1030,833,107Y09M
10009,10009140,10009140-007,351,906,536,370,107Y09M
10009,10009100,10009100-006,950,3033,1602,1431,107Y09M
10009,10009100,10009100-004,210,592,319,273,107Y09M
10009,10009100,10009100-002,1499,4432,2270,2162,107Y09M
10009,10009100,10009100-003,855,2592,1355,1237,107Y09M
10009,10009100,10009100-001,435,1221,621,600,107Y09M
10009,10009100,10009100-005,316,951,524,427,107Y09M
10009,10009100,10009100-010,674,2111,1102,1009,107Y09M
10009,10009100,10009100-009,423,1232,645,587,107Y09M
10009,10009100,10009100-008,425,1302,697,605,107Y09M
10009,10009100,10009100-007,248,726,390,336,107Y09M
10009,10009030,10009030-013,540,1536,808,728,107Y09M
10009,10009030,10009030-026,550,1758,951,807,107Y09M
10009,10009030,10009030-001,432,1112,547,565,107Y09M
10009,10009030,10009030-025,513,1563,824,739,107Y09M
10009,10009030,10009030-004,1341,3551,1747,1804,107Y09M
10009,10009030,10009030-014,294,1031,528,503,107Y09M
10009,10009030,10009030-008,2071,5825,2843,2982,107Y09M
10009,10009030,10009030-028,1765,4606,2231,2375,107Y09M
10009,10009030,10009030-020,663,2004,1024,980,107Y09M
10009,10009030,10009030-007,683,1746,872,874,107Y09M
10009,10009030,10009030-016,580,1773,946,827,107Y09M
10009,10009030,10009030-006,1482,3964,1929,2035,107Y09M
10009,10009030,10009030-012,456,1362,712,650,107Y09M
10009,10009030,10009030-003,1182,3392,1646,1746,107Y09M
10009,10009030,10009030-029,452,1450,772,678,107Y09M
10009,10009030,10009030-017,336,1018,571,447,107Y09M
10009,10009030,10009030-027,290,640,356,284,107Y09M
10009,10009030,10009030-018,1002,3074,1572,1502,107Y09M
10009,10009030,10009030-024,939,3024,1605,1419,107Y09M
10009,10009030,10009030-019,319,939,482,457,107Y09M
10009,10009030,10009030-023,951,2710,1397,1313,107Y09M
10009,10009030,10009030-022,1277,3762,1937,1825,107Y09M
10009,10009030,10009030-010,1739,4889,2400,2489,107Y09M
10009,10009030,10009030-002,851,1960,1002,958,107Y09M
10009,10009030,10009030-005,1214,3164,1534,1630,107Y09M
10009,10009030,10009030-015,779,1882,958,924,107Y09M
10009,10009030,10009030-011,844,2419,1221,1198,107Y09M
10009,10009030,10009030-021,699,1892,999,893,107Y09M
10009,10009030,10009030-009,976,2856,1481,1375,107Y09M
10009,10009120,10009120-009,637,1734,965,769,107Y09M
10009,10009120,10009120-008,315,958,522,436,107Y09M
10009,10009120,10009120-013,466,1367,717,650,107Y09M
10009,10009120,10009120-002,572,1679,856,823,107Y09M
10009,10009120,10009120-014,311,914,486,428,107Y09M
10009,10009120,10009120-001,489,1332,677,655,107Y09M
10009,10009120,10009120-007,782,2408,1281,1127,107Y09M
10009,10009120,10009120-003,1002,2752,1403,1349,107Y09M
10009,10009120,10009120-011,545,1690,907,783,107Y09M
10009,10009120,10009120-004,905,2384,1261,1123,107Y09M
10009,10009120,10009120-006,516,1510,800,710,107Y09M
10009,10009120,10009120-012,422,1318,683,635,107Y09M
10009,10009120,10009120-010,738,2032,1104,928,107Y09M
10009,10009120,10009120-005,825,2394,1253,1141,107Y09M
10009,10009130,10009130-008,780,2394,1194,1200,107Y09M
10009,10009130,10009130-013,583,1783,893,890,107Y09M
10009,10009130,10009130-003,745,2329,1220,1109,107Y09M
10009,10009130,10009130-006,1087,3570,1810,1760,107Y09M
10009,10009130,10009130-011,1305,4171,2146,2025,107Y09M
10009,10009130,10009130-007,845,2575,1273,1302,107Y09M
10009,10009130,10009130-005,942,3063,1575,1488,107Y09M
10009,10009130,10009130-001,1673,5130,2506,2624,107Y09M
10009,10009130,10009130-002,2879,9253,4453,4800,107Y09M
10009,10009130,10009130-010,421,1341,710,631,107Y09M
10009,10009130,10009130-012,753,2543,1266,1277,107Y09M
10009,10009130,10009130-009,1483,4735,2420,2315,107Y09M
10009,10009130,10009130-004,972,2972,1526,1446,107Y09M
10009,10009090,10009090-007,1153,3540,1819,1721,107Y09M
10009,10009090,10009090-013,469,1567,840,727,107Y09M
10009,10009090,10009090-014,647,2083,1125,958,107Y09M
10009,10009090,10009090-011,635,2051,1064,987,107Y09M
10009,10009090,10009090-003,575,1768,910,858,107Y09M
10009,10009090,10009090-002,324,1016,532,484,107Y09M
10009,10009090,10009090-006,753,2282,1193,1089,107Y09M
10009,10009090,10009090-008,474,1466,768,698,107Y09M
10009,10009090,10009090-012,587,1737,921,816,107Y09M
10009,10009090,10009090-001,1732,4960,2564,2396,107Y09M
10009,10009090,10009090-005,395,1273,684,589,107Y09M
10009,10009090,10009090-004,465,1377,712,665,107Y09M
10009,10009090,10009090-010,722,2283,1201,1082,107Y09M
10009,10009090,10009090-009,456,1344,703,641,107Y09M
10009,10009160,10009160-010,369,956,535,421,107Y09M
10009,10009160,10009160-015,771,2062,1054,1008,107Y09M
10009,10009160,10009160-009,200,491,279,212,107Y09M
10009,10009160,10009160-006,778,2131,1207,924,107Y09M
10009,10009160,10009160-001,499,1410,704,706,107Y09M
10009,10009160,10009160-012,566,1636,856,780,107Y09M
10009,10009160,10009160-008,296,765,409,356,107Y09M
10009,10009160,10009160-013,1215,3470,1883,1587,107Y09M
10009,10009160,10009160-007,262,701,386,315,107Y09M
10009,10009160,10009160-004,785,2336,1204,1132,107Y09M
10009,10009160,10009160-002,424,1241,662,579,107Y09M
10009,10009160,10009160-003,458,1240,638,602,107Y09M
10009,10009160,10009160-014,745,2017,1112,905,107Y09M
10009,10009160,10009160-011,587,1736,920,816,107Y09M
10009,10009160,10009160-005,710,1670,944,726,107Y09M
10009,10009150,10009150-001,783,2199,1144,1055,107Y09M
10009,10009150,10009150-003,591,1774,940,834,107Y09M
10009,10009150,10009150-007,295,881,477,404,107Y09M
10009,10009150,10009150-006,350,994,557,437,107Y09M
10009,10009150,10009150-002,585,1730,911,819,107Y09M
10009,10009150,10009150-005,543,1738,917,821,107Y09M
10009,10009150,10009150-004,456,1323,725,598,107Y09M
10009,10009150,10009150-009,356,977,554,423,107Y09M
10009,10009150,10009150-008,481,1376,755,621,107Y09M
65000,65000230,65000230-010,541,1771,900,871,107Y09M
65000,65000230,65000230-003,1224,3303,1712,1591,107Y09M
65000,65000230,65000230-002,1469,3682,1877,1805,107Y09M
65000,65000230,65000230-009,486,1788,954,834,107Y09M
65000,65000230,65000230-007,1993,4937,2461,2476,107Y09M
65000,65000230,65000230-008,622,1956,1020,936,107Y09M
65000,65000230,65000230-004,1598,4166,2077,2089,107Y09M
65000,65000230,65000230-005,803,2188,1058,1130,107Y09M
65000,65000230,65000230-001,3225,7390,3584,3806,107Y09M
65000,65000230,65000230-006,2887,7625,3728,3897,107Y09M
65000,65000210,65000210-001,142,348,195,153,107Y09M
65000,65000210,65000210-003,551,1184,615,569,107Y09M
65000,65000210,65000210-012,256,656,374,282,107Y09M
65000,65000210,65000210-009,1154,2251,1150,1101,107Y09M
65000,65000210,65000210-006,301,704,370,334,107Y09M
65000,65000210,65000210-005,2900,7227,3638,3589,107Y09M
65000,65000210,65000210-002,2204,5599,2745,2854,107Y09M
65000,65000210,65000210-011,212,602,347,255,107Y09M
65000,65000210,65000210-004,366,940,504,436,107Y09M
65000,65000210,65000210-010,364,895,451,444,107Y09M
65000,65000210,65000210-007,226,544,314,230,107Y09M
65000,65000210,65000210-013,548,1319,717,602,107Y09M
65000,65000210,65000210-008,302,768,448,320,107Y09M
65000,65000020,65000020-002,577,1677,852,825,107Y09M
65000,65000020,65000020-019,1296,3580,1761,1819,107Y09M
65000,65000020,65000020-072,1232,2757,1317,1440,107Y09M
65000,65000020,65000020-028,936,2060,994,1066,107Y09M
65000,65000020,65000020-031,676,1736,871,865,107Y09M
65000,65000020,65000020-001,2009,5496,2730,2766,107Y09M
65000,65000020,65000020-042,1158,2944,1472,1472,107Y09M
65000,65000020,65000020-060,356,868,409,459,107Y09M
65000,65000020,65000020-041,1206,2842,1384,1458,107Y09M
65000,65000020,65000020-052,861,1901,921,980,107Y09M
65000,65000020,65000020-026,575,1418,716,702,107Y09M
65000,65000020,65000020-029,530,1319,653,666,107Y09M
65000,65000020,65000020-005,1593,4025,2031,1994,107Y09M
65000,65000020,65000020-109,725,1769,913,856,107Y09M
65000,65000020,65000020-095,1477,4399,2184,2215,107Y09M
65000,65000020,65000020-104,2114,5492,2643,2849,107Y09M
65000,65000020,65000020-119,1506,4166,2065,2101,107Y09M
65000,65000020,65000020-096,1650,4022,1920,2102,107Y09M
65000,65000020,65000020-097,1271,3339,1669,1670,107Y09M
65000,65000020,65000020-118,1689,4346,2115,2231,107Y09M
65000,65000020,65000020-034,510,1310,653,657,107Y09M
65000,65000020,65000020-032,894,2096,1064,1032,107Y09M
65000,65000020,65000020-065,513,1241,609,632,107Y09M
65000,65000020,65000020-077,1501,3955,1937,2018,107Y09M
65000,65000020,65000020-078,2015,5948,2944,3004,107Y09M
65000,65000020,65000020-051,977,2459,1229,1230,107Y09M
65000,65000020,65000020-030,638,1553,801,752,107Y09M
65000,65000020,65000020-049,848,2047,988,1059,107Y09M
65000,65000020,65000020-048,768,1900,954,946,107Y09M
65000,65000020,65000020-047,519,1227,596,631,107Y09M
65000,65000020,65000020-045,1723,4458,2189,2269,107Y09M
65000,65000020,65000020-112,1197,3118,1524,1594,107Y09M
65000,65000020,65000020-091,1552,4393,2166,2227,107Y09M
65000,65000020,65000020-025,802,2040,1000,1040,107Y09M
65000,65000020,65000020-090,2021,5781,2773,3008,107Y09M
65000,65000020,65000020-088,1271,3533,1712,1821,107Y09M
65000,65000020,65000020-113,2196,6146,3076,3070,107Y09M
65000,65000020,65000020-114,1898,5469,2630,2839,107Y09M
65000,65000020,65000020-092,964,2631,1333,1298,107Y09M
65000,65000020,65000020-089,2031,5726,2776,2950,107Y09M
65000,65000020,65000020-087,1897,5233,2557,2676,107Y09M
65000,65000020,65000020-040,629,1382,659,723,107Y09M
65000,65000020,65000020-115,2182,6339,3113,3226,107Y09M
65000,65000020,65000020-017,2348,6642,3253,3389,107Y09M
65000,65000020,65000020-015,1613,4256,2118,2138,107Y09M
65000,65000020,65000020-018,2417,6469,3122,3347,107Y09M
65000,65000020,65000020-116,1316,3563,1731,1832,107Y09M
65000,65000020,65000020-021,1295,2572,1261,1311,107Y09M
65000,65000020,65000020-013,1942,4550,2214,2336,107Y09M
65000,65000020,65000020-020,3042,7876,3823,4053,107Y09M
65000,65000020,65000020-057,920,2079,1011,1068,107Y09M
65000,65000020,65000020-014,2587,6428,3183,3245,107Y09M
65000,65000020,65000020-035,658,1467,712,755,107Y09M
65000,65000020,65000020-036,633,1560,767,793,107Y09M
65000,65000020,65000020-027,635,1472,728,744,107Y09M
65000,65000020,65000020-022,591,1483,769,714,107Y09M
65000,65000020,65000020-023,729,1819,903,916,107Y09M
65000,65000020,65000020-075,905,2158,1038,1120,107Y09M
65000,65000020,65000020-007,2766,6554,3132,3422,107Y09M
65000,65000020,65000020-050,757,1877,912,965,107Y09M
65000,65000020,65000020-070,545,1412,693,719,107Y09M
65000,65000020,65000020-004,343,969,516,453,107Y09M
65000,65000020,65000020-085,1237,3275,1578,1697,107Y09M
65000,65000020,65000020-076,1888,4818,2382,2436,107Y09M
65000,65000020,65000020-033,780,1884,939,945,107Y09M
65000,65000020,65000020-080,649,1876,958,918,107Y09M
65000,65000020,65000020-061,1037,2558,1296,1262,107Y09M
65000,65000020,65000020-058,381,915,445,470,107Y09M
65000,65000020,65000020-056,904,2296,1147,1149,107Y09M
65000,65000020,65000020-062,902,2109,1040,1069,107Y09M
65000,65000020,65000020-063,945,2353,1170,1183,107Y09M
65000,65000020,65000020-064,640,1612,776,836,107Y09M
65000,65000020,65000020-074,868,2053,989,1064,107Y09M
65000,65000020,65000020-083,1475,3856,1892,1964,107Y09M
65000,65000020,65000020-071,773,1828,902,926,107Y09M
65000,65000020,65000020-012,1486,3817,1857,1960,107Y09M
65000,65000020,65000020-044,1438,3788,1865,1923,107Y09M
65000,65000020,65000020-046,613,1504,740,764,107Y09M
65000,65000020,65000020-043,1134,2851,1375,1476,107Y09M
65000,65000020,65000020-086,1440,3929,1954,1975,107Y09M
65000,65000020,65000020-082,1555,4171,2115,2056,107Y09M
65000,65000020,65000020-039,1867,3984,1878,2106,107Y09M
65000,65000020,65000020-003,880,2380,1197,1183,107Y09M
65000,65000020,65000020-110,1660,4785,2344,2441,107Y09M
65000,65000020,65000020-106,1342,3420,1726,1694,107Y09M
65000,65000020,65000020-105,2845,6643,3152,3491,107Y09M
65000,65000020,65000020-107,793,2176,1042,1134,107Y09M
65000,65000020,65000020-024,919,2359,1134,1225,107Y09M
65000,65000020,65000020-059,679,1552,778,774,107Y09M
65000,65000020,65000020-079,871,2304,1184,1120,107Y09M
65000,65000020,65000020-102,935,2636,1281,1355,107Y09M
65000,65000020,65000020-099,894,2388,1170,1218,107Y09M
65000,65000020,65000020-103,1813,4915,2448,2467,107Y09M
65000,65000020,65000020-100,839,2226,1113,1113,107Y09M
65000,65000020,65000020-101,1372,3631,1777,1854,107Y09M
65000,65000020,65000020-098,943,2287,1163,1124,107Y09M
65000,65000020,65000020-093,3448,8611,4173,4438,107Y09M
65000,65000020,65000020-081,935,2500,1233,1267,107Y09M
65000,65000020,65000020-066,827,2081,1014,1067,107Y09M
65000,65000020,65000020-010,5198,9697,5331,4366,107Y09M
65000,65000020,65000020-108,3658,8106,3865,4241,107Y09M
65000,65000020,65000020-009,1372,3699,1821,1878,107Y09M
65000,65000020,65000020-016,1255,3636,1836,1800,107Y09M
65000,65000020,65000020-073,1276,3150,1548,1602,107Y09M
65000,65000020,65000020-038,1034,2345,1078,1267,107Y09M
65000,65000020,65000020-037,529,1146,529,617,107Y09M
65000,65000020,65000020-008,2325,5780,2765,3015,107Y09M
65000,65000020,65000020-094,1857,4858,2317,2541,107Y09M
65000,65000020,65000020-111,1738,4182,1992,2190,107Y09M
65000,65000020,65000020-117,1527,3916,1937,1979,107Y09M
65000,65000020,65000020-084,1167,3102,1520,1582,107Y09M
65000,65000020,65000020-006,168,393,189,204,107Y09M
65000,65000020,65000020-011,846,2141,1053,1088,107Y09M
65000,65000020,65000020-055,786,1904,908,996,107Y09M
65000,65000020,65000020-067,944,2433,1208,1225,107Y09M
65000,65000020,65000020-054,656,1537,739,798,107Y09M
65000,65000020,65000020-069,780,1948,960,988,107Y09M
65000,65000020,65000020-068,1265,3453,1680,1773,107Y09M
65000,65000020,65000020-053,416,994,495,499,107Y09M
65000,65000090,65000090-026,1362,3767,1908,1859,107Y09M
65000,65000090,65000090-003,1514,4254,2129,2125,107Y09M
65000,65000090,65000090-001,127,321,184,137,107Y09M
65000,65000090,65000090-010,1447,4265,2266,1999,107Y09M
65000,65000090,65000090-025,1780,5566,2783,2783,107Y09M
65000,65000090,65000090-004,1222,3323,1640,1683,107Y09M
65000,65000090,65000090-014,371,943,506,437,107Y09M
65000,65000090,65000090-023,2631,7081,3616,3465,107Y09M
65000,65000090,65000090-005,423,1235,695,540,107Y09M
65000,65000090,65000090-006,2823,7976,3821,4155,107Y09M
65000,65000090,65000090-021,591,1546,860,686,107Y09M
65000,65000090,65000090-024,2794,7902,3894,4008,107Y09M
65000,65000090,65000090-020,330,1017,554,463,107Y09M
65000,65000090,65000090-016,371,812,485,327,107Y09M
65000,65000090,65000090-022,905,2115,1188,927,107Y09M
65000,65000090,65000090-002,285,709,346,363,107Y09M
65000,65000090,65000090-013,231,566,336,230,107Y09M
65000,65000090,65000090-012,423,1204,641,563,107Y09M
65000,65000090,65000090-015,367,736,429,307,107Y09M
65000,65000090,65000090-017,883,2543,1342,1201,107Y09M
65000,65000090,65000090-019,1063,3255,1691,1564,107Y09M
65000,65000090,65000090-018,558,1630,902,728,107Y09M
65000,65000090,65000090-011,790,2506,1432,1074,107Y09M
65000,65000090,65000090-008,3911,10682,5310,5372,107Y09M
65000,65000090,65000090-009,3728,10078,4964,5114,107Y09M
65000,65000090,65000090-028,3062,7280,3477,3803,107Y09M
65000,65000090,65000090-027,6895,16316,7556,8760,107Y09M
65000,65000090,65000090-007,2257,6042,2957,3085,107Y09M
65000,65000130,65000130-002,846,2152,1042,1110,107Y09M
65000,65000130,65000130-020,1993,5080,2537,2543,107Y09M
65000,65000130,65000130-041,1262,3400,1622,1778,107Y09M
65000,65000130,65000130-007,2193,6060,2961,3099,107Y09M
65000,65000130,65000130-006,1762,4861,2393,2468,107Y09M
65000,65000130,65000130-018,2458,7234,3568,3666,107Y09M
65000,65000130,65000130-038,1970,5542,2734,2808,107Y09M
65000,65000130,65000130-021,3215,8691,4338,4353,107Y09M
65000,65000130,65000130-014,1656,4634,2260,2374,107Y09M
65000,65000130,65000130-031,1843,5187,2557,2630,107Y09M
65000,65000130,65000130-019,1735,5100,2537,2563,107Y09M
65000,65000130,65000130-022,1868,4782,2441,2341,107Y09M
65000,65000130,65000130-034,1584,4536,2295,2241,107Y09M
65000,65000130,65000130-040,2492,6764,3221,3543,107Y09M
65000,65000130,65000130-047,1576,4400,2189,2211,107Y09M
65000,65000130,65000130-030,1717,4661,2341,2320,107Y09M
65000,65000130,65000130-043,2416,6037,2779,3258,107Y09M
65000,65000130,65000130-046,2392,6410,3042,3368,107Y09M
65000,65000130,65000130-005,811,2118,1029,1089,107Y09M
65000,65000130,65000130-045,1087,3188,1578,1610,107Y09M
65000,65000130,65000130-032,1103,3117,1510,1607,107Y09M
65000,65000130,65000130-009,1420,3702,1802,1900,107Y09M
65000,65000130,65000130-004,2027,5861,2891,2970,107Y09M
65000,65000130,65000130-003,2427,6190,2997,3193,107Y09M
65000,65000130,65000130-037,1665,4603,2274,2329,107Y09M
65000,65000130,65000130-033,2093,5703,2858,2845,107Y09M
65000,65000130,65000130-026,610,1749,902,847,107Y09M
65000,65000130,65000130-010,3185,8939,4323,4616,107Y09M
65000,65000130,65000130-001,2827,5479,3160,2319,107Y09M
65000,65000130,65000130-015,621,1689,890,799,107Y09M
65000,65000130,65000130-012,2944,8446,4109,4337,107Y09M
65000,65000130,65000130-013,2241,6468,3237,3231,107Y09M
65000,65000130,65000130-016,2716,7179,3544,3635,107Y09M
65000,65000130,65000130-008,1790,4558,2242,2316,107Y09M
65000,65000130,65000130-023,1989,5217,2553,2664,107Y09M
65000,65000130,65000130-025,1242,3081,1473,1608,107Y09M
65000,65000130,65000130-024,2070,5526,2787,2739,107Y09M
65000,65000130,65000130-035,1703,4760,2335,2425,107Y09M
65000,65000130,65000130-011,1250,3227,1576,1651,107Y09M
65000,65000130,65000130-036,2155,5804,2825,2979,107Y09M
65000,65000130,65000130-028,2106,5978,2928,3050,107Y09M
65000,65000130,65000130-044,1323,3653,1737,1916,107Y09M
65000,65000130,65000130-027,1982,5316,2597,2719,107Y09M
65000,65000130,65000130-042,1852,5077,2450,2627,107Y09M
65000,65000130,65000130-039,1166,3392,1685,1707,107Y09M
65000,65000130,65000130-029,1272,3722,1789,1933,107Y09M
65000,65000130,65000130-017,2644,7719,3844,3875,107Y09M
65000,65000030,65000030-009,2475,6350,3038,3312,107Y09M
65000,65000030,65000030-083,1095,2884,1406,1478,107Y09M
65000,65000030,65000030-005,1568,4209,2038,2171,107Y09M
65000,65000030,65000030-023,2100,4423,2054,2369,107Y09M
65000,65000030,65000030-001,2652,6109,2997,3112,107Y09M
65000,65000030,65000030-081,2811,7177,3438,3739,107Y09M
65000,65000030,65000030-004,1572,4390,2183,2207,107Y09M
65000,65000030,65000030-042,1845,5272,2666,2606,107Y09M
65000,65000030,65000030-059,2032,5448,2650,2798,107Y09M
65000,65000030,65000030-044,4097,7421,4125,3296,107Y09M
65000,65000030,65000030-002,3829,9538,4585,4953,107Y09M
65000,65000030,65000030-093,1258,3056,1454,1602,107Y09M
65000,65000030,65000030-092,1364,3650,1839,1811,107Y09M
65000,65000030,65000030-068,1762,4255,2038,2217,107Y09M
65000,65000030,65000030-061,1903,5208,2591,2617,107Y09M
65000,65000030,65000030-087,1107,2887,1428,1459,107Y09M
65000,65000030,65000030-056,934,2566,1261,1305,107Y09M
65000,65000030,65000030-017,2276,5745,2744,3001,107Y09M
65000,65000030,65000030-082,1291,3103,1445,1658,107Y09M
65000,65000030,65000030-022,2731,6070,2877,3193,107Y09M
65000,65000030,65000030-021,1392,3180,1511,1669,107Y09M
65000,65000030,65000030-075,1963,4444,2086,2358,107Y09M
65000,65000030,65000030-020,1597,3681,1728,1953,107Y09M
65000,65000030,65000030-062,1843,4767,2302,2465,107Y09M
65000,65000030,65000030-054,242,820,442,378,107Y09M
65000,65000030,65000030-066,1917,5182,2574,2608,107Y09M
65000,65000030,65000030-077,1090,2549,1245,1304,107Y09M
65000,65000030,65000030-027,1814,4704,2259,2445,107Y09M
65000,65000030,65000030-033,1464,3510,1694,1816,107Y09M
65000,65000030,65000030-072,1587,3871,1866,2005,107Y09M
65000,65000030,65000030-028,1379,3618,1775,1843,107Y09M
65000,65000030,65000030-031,2401,5128,2367,2761,107Y09M
65000,65000030,65000030-032,2146,4577,2101,2476,107Y09M
65000,65000030,65000030-030,2876,6508,3165,3343,107Y09M
65000,65000030,65000030-076,1099,2756,1381,1375,107Y09M
65000,65000030,65000030-029,1950,4828,2352,2476,107Y09M
65000,65000030,65000030-019,2140,5041,2404,2637,107Y09M
65000,65000030,65000030-046,1870,4578,2178,2400,107Y09M
65000,65000030,65000030-074,828,1906,920,986,107Y09M
65000,65000030,65000030-038,1860,4947,2456,2491,107Y09M
65000,65000030,65000030-071,1555,4123,2037,2086,107Y09M
65000,65000030,65000030-064,1668,4655,2334,2321,107Y09M
65000,65000030,65000030-010,1539,3830,1879,1951,107Y09M
65000,65000030,65000030-036,1785,4390,2150,2240,107Y09M
65000,65000030,65000030-003,1653,4473,2231,2242,107Y09M
65000,65000030,65000030-090,1293,3473,1759,1714,107Y09M
65000,65000030,65000030-026,2211,5355,2620,2735,107Y09M
65000,65000030,65000030-006,1412,3678,1796,1882,107Y09M
65000,65000030,65000030-057,2799,6966,3396,3570,107Y09M
65000,65000030,65000030-088,1405,3582,1802,1780,107Y09M
65000,65000030,65000030-024,1456,3598,1703,1895,107Y09M
65000,65000030,65000030-069,1512,4043,1966,2077,107Y09M
65000,65000030,65000030-091,1313,3472,1711,1761,107Y09M
65000,65000030,65000030-039,1805,4233,2024,2209,107Y09M
65000,65000030,65000030-065,1266,3316,1660,1656,107Y09M
65000,65000030,65000030-007,1241,2451,1126,1325,107Y09M
65000,65000030,65000030-008,2610,6646,3173,3473,107Y09M
65000,65000030,65000030-034,1127,3111,1507,1604,107Y09M
65000,65000030,65000030-045,2096,5333,2513,2820,107Y09M
65000,65000030,65000030-051,1536,3608,1736,1872,107Y09M
65000,65000030,65000030-047,2478,5494,2590,2904,107Y09M
65000,65000030,65000030-079,900,2220,1060,1160,107Y09M
65000,65000030,65000030-050,2002,4752,2345,2407,107Y09M
65000,65000030,65000030-040,1336,3267,1558,1709,107Y09M
65000,65000030,65000030-048,1465,3663,1754,1909,107Y09M
65000,65000030,65000030-049,2636,5839,2726,3113,107Y09M
65000,65000030,65000030-037,2110,5244,2568,2676,107Y09M
65000,65000030,65000030-035,2867,7571,3620,3951,107Y09M
65000,65000030,65000030-025,3588,8507,3943,4564,107Y09M
65000,65000030,65000030-063,989,2515,1173,1342,107Y09M
65000,65000030,65000030-060,1468,4166,2070,2096,107Y09M
65000,65000030,65000030-089,1671,4565,2251,2314,107Y09M
65000,65000030,65000030-058,1026,2917,1450,1467,107Y09M
65000,65000030,65000030-043,950,2450,1236,1214,107Y09M
65000,65000030,65000030-070,1840,4775,2275,2500,107Y09M
65000,65000030,65000030-011,1597,3764,1825,1939,107Y09M
65000,65000030,65000030-084,1774,4466,2188,2278,107Y09M
65000,65000030,65000030-018,1492,3776,1863,1913,107Y09M
65000,65000030,65000030-080,1572,4404,2091,2313,107Y09M
65000,65000030,65000030-015,1732,4579,2240,2339,107Y09M
65000,65000030,65000030-013,1714,4293,2083,2210,107Y09M
65000,65000030,65000030-016,2093,5173,2517,2656,107Y09M
65000,65000030,65000030-014,1846,4356,2064,2292,107Y09M
65000,65000030,65000030-012,1780,4585,2231,2354,107Y09M
65000,65000030,65000030-073,2834,6905,3321,3584,107Y09M
65000,65000030,65000030-067,1789,4713,2313,2400,107Y09M
65000,65000030,65000030-041,131,348,181,167,107Y09M
65000,65000030,65000030-055,3473,8511,4121,4390,107Y09M
65000,65000030,65000030-078,1280,3206,1545,1661,107Y09M
65000,65000030,65000030-085,1639,4517,2204,2313,107Y09M
65000,65000030,65000030-052,2072,5818,2845,2973,107Y09M
65000,65000030,65000030-053,962,2336,1185,1151,107Y09M
65000,65000030,65000030-086,1453,4052,1976,2076,107Y09M
65000,65000150,65000150-008,1902,4615,2412,2203,107Y09M
65000,65000150,65000150-009,1310,3694,1886,1808,107Y09M
65000,65000150,65000150-007,474,1525,853,672,107Y09M
65000,65000150,65000150-015,1466,3977,1961,2016,107Y09M
65000,65000150,65000150-019,2921,8093,4036,4057,107Y09M
65000,65000150,65000150-017,1303,3643,1824,1819,107Y09M
65000,65000150,65000150-006,2635,6616,3316,3300,107Y09M
65000,65000150,65000150-005,2284,6369,3247,3122,107Y09M
65000,65000150,65000150-018,3855,8881,4495,4386,107Y09M
65000,65000150,65000150-014,1218,3388,1691,1697,107Y09M
65000,65000150,65000150-002,459,1259,661,598,107Y09M
65000,65000150,65000150-011,1092,2592,1265,1327,107Y09M
65000,65000150,65000150-012,1241,3212,1548,1664,107Y09M
65000,65000150,65000150-003,1543,4041,2053,1988,107Y09M
65000,65000150,65000150-016,1419,4080,2028,2052,107Y09M
65000,65000150,65000150-020,1307,3464,1735,1729,107Y09M
65000,65000150,65000150-010,1981,5550,2770,2780,107Y09M
65000,65000150,65000150-013,1734,4728,2277,2451,107Y09M
65000,65000150,65000150-001,1703,4907,2531,2376,107Y09M
65000,65000150,65000150-004,539,1485,813,672,107Y09M
65000,65000240,65000240-011,454,954,513,441,107Y09M
65000,65000240,65000240-010,93,187,99,88,107Y09M
65000,65000240,65000240-005,115,265,141,124,107Y09M
65000,65000240,65000240-003,129,272,149,123,107Y09M
65000,65000240,65000240-004,220,497,271,226,107Y09M
65000,65000240,65000240-007,243,449,255,194,107Y09M
65000,65000240,65000240-009,199,384,228,156,107Y09M
65000,65000240,65000240-008,104,152,87,65,107Y09M
65000,65000240,65000240-002,127,259,142,117,107Y09M
65000,65000240,65000240-012,95,167,101,66,107Y09M
65000,65000240,65000240-006,315,696,383,313,107Y09M
65000,65000240,65000240-001,205,419,230,189,107Y09M
65000,65000040,65000040-046,1636,4193,2035,2158,107Y09M
65000,65000040,65000040-051,1516,3657,1757,1900,107Y09M
65000,65000040,65000040-022,925,2026,937,1089,107Y09M
65000,65000040,65000040-042,403,987,500,487,107Y09M
65000,65000040,65000040-032,1218,2688,1233,1455,107Y09M
65000,65000040,65000040-014,2100,5267,2610,2657,107Y09M
65000,65000040,65000040-018,1393,3136,1434,1702,107Y09M
65000,65000040,65000040-005,1166,2765,1314,1451,107Y09M
65000,65000040,65000040-002,1222,2904,1379,1525,107Y09M
65000,65000040,65000040-026,1666,4163,1979,2184,107Y09M
65000,65000040,65000040-053,1005,2325,1080,1245,107Y09M
65000,65000040,65000040-034,1617,4261,2005,2256,107Y09M
65000,65000040,65000040-049,1564,4247,1985,2262,107Y09M
65000,65000040,65000040-008,1214,2987,1335,1652,107Y09M
65000,65000040,65000040-016,1926,4927,2322,2605,107Y09M
65000,65000040,65000040-059,1142,3192,1550,1642,107Y09M
65000,65000040,65000040-035,1967,4992,2433,2559,107Y09M
65000,65000040,65000040-017,1742,4723,2273,2450,107Y09M
65000,65000040,65000040-011,1953,4965,2303,2662,107Y09M
65000,65000040,65000040-015,1816,4279,1986,2293,107Y09M
65000,65000040,65000040-009,436,1009,495,514,107Y09M
65000,65000040,65000040-006,1435,3538,1670,1868,107Y09M
65000,65000040,65000040-007,1164,2866,1380,1486,107Y09M
65000,65000040,65000040-061,1146,2560,1169,1391,107Y09M
65000,65000040,65000040-054,1320,3304,1556,1748,107Y09M
65000,65000040,65000040-004,1323,3124,1408,1716,107Y09M
65000,65000040,65000040-036,766,1764,816,948,107Y09M
65000,65000040,65000040-025,1743,4037,1865,2172,107Y09M
65000,65000040,65000040-023,1556,3848,1838,2010,107Y09M
65000,65000040,65000040-060,1235,3202,1529,1673,107Y09M
65000,65000040,65000040-021,1195,3020,1477,1543,107Y09M
65000,65000040,65000040-047,2077,5154,2456,2698,107Y09M
65000,65000040,65000040-012,1576,3993,1938,2055,107Y09M
65000,65000040,65000040-020,1587,4132,2016,2116,107Y09M
65000,65000040,65000040-050,1077,2824,1367,1457,107Y09M
65000,65000040,65000040-027,1304,3046,1474,1572,107Y09M
65000,65000040,65000040-044,2099,5043,2403,2640,107Y09M
65000,65000040,65000040-056,1910,4309,1935,2374,107Y09M
65000,65000040,65000040-010,308,856,433,423,107Y09M
65000,65000040,65000040-028,1556,3480,1661,1819,107Y09M
65000,65000040,65000040-048,1334,3289,1602,1687,107Y09M
65000,65000040,65000040-057,1235,2697,1213,1484,107Y09M
65000,65000040,65000040-033,1987,5038,2403,2635,107Y09M
65000,65000040,65000040-013,2973,7507,3560,3947,107Y09M
65000,65000040,65000040-062,4410,10660,4959,5701,107Y09M
65000,65000040,65000040-043,984,2162,995,1167,107Y09M
65000,65000040,65000040-058,860,1940,933,1007,107Y09M
65000,65000040,65000040-055,1527,3849,1850,1999,107Y09M
65000,65000040,65000040-039,1832,4408,2060,2348,107Y09M
65000,65000040,65000040-029,1086,2540,1186,1354,107Y09M
65000,65000040,65000040-037,1026,2426,1168,1258,107Y09M
65000,65000040,65000040-040,1383,3517,1673,1844,107Y09M
65000,65000040,65000040-045,980,2277,1128,1149,107Y09M
65000,65000040,65000040-041,360,878,450,428,107Y09M
65000,65000040,65000040-038,2320,5336,2512,2824,107Y09M
65000,65000040,65000040-001,1452,3549,1713,1836,107Y09M
65000,65000040,65000040-052,511,1246,623,623,107Y09M
65000,65000040,65000040-031,2005,5031,2426,2605,107Y09M
65000,65000040,65000040-030,1933,4738,2161,2577,107Y09M
65000,65000040,65000040-003,2657,4909,2531,2378,107Y09M
65000,65000040,65000040-019,579,1306,615,691,107Y09M
65000,65000040,65000040-024,1720,4101,1872,2229,107Y09M
65000,65000220,65000220-004,364,991,552,439,107Y09M
65000,65000220,65000220-005,685,1835,935,900,107Y09M
65000,65000220,65000220-006,648,1761,917,844,107Y09M
65000,65000220,65000220-003,855,2509,1272,1237,107Y09M
65000,65000220,65000220-008,234,704,371,333,107Y09M
65000,65000220,65000220-009,378,1089,558,531,107Y09M
65000,65000220,65000220-007,147,352,203,149,107Y09M
65000,65000220,65000220-002,552,1608,784,824,107Y09M
65000,65000220,65000220-001,459,1311,701,610,107Y09M
65000,65000190,65000190-008,348,827,481,346,107Y09M
65000,65000190,65000190-011,390,912,464,448,107Y09M
65000,65000190,65000190-007,275,685,368,317,107Y09M
65000,65000190,65000190-001,181,438,238,200,107Y09M
65000,65000190,65000190-009,147,299,174,125,107Y09M
65000,65000190,65000190-012,505,1079,561,518,107Y09M
65000,65000190,65000190-004,343,705,405,300,107Y09M
65000,65000190,65000190-005,161,349,191,158,107Y09M
65000,65000190,65000190-003,301,772,432,340,107Y09M
65000,65000190,65000190-002,407,871,472,399,107Y09M
65000,65000190,65000190-006,216,430,254,176,107Y09M
65000,65000190,65000190-010,117,348,185,163,107Y09M
65000,65000110,65000110-017,470,1048,569,479,107Y09M
65000,65000110,65000110-041,1287,2901,1378,1523,107Y09M
65000,65000110,65000110-040,1177,2815,1361,1454,107Y09M
65000,65000110,65000110-026,3561,7695,3738,3957,107Y09M
65000,65000110,65000110-028,775,1774,859,915,107Y09M
65000,65000110,65000110-032,1832,4492,2167,2325,107Y09M
65000,65000110,65000110-020,2629,5613,2654,2959,107Y09M
65000,65000110,65000110-019,1835,4560,2315,2245,107Y09M
65000,65000110,65000110-021,1870,4547,2271,2276,107Y09M
65000,65000110,65000110-014,2545,6275,3208,3067,107Y09M
65000,65000110,65000110-031,2374,5582,2682,2900,107Y09M
65000,65000110,65000110-046,1841,4674,2311,2363,107Y09M
65000,65000110,65000110-006,2706,5706,2992,2714,107Y09M
65000,65000110,65000110-025,1480,3052,1435,1617,107Y09M
65000,65000110,65000110-037,1585,3450,1650,1800,107Y09M
65000,65000110,65000110-030,3741,8243,3956,4287,107Y09M
65000,65000110,65000110-023,285,631,329,302,107Y09M
65000,65000110,65000110-039,2049,4184,2048,2136,107Y09M
65000,65000110,65000110-033,2364,5218,2530,2688,107Y09M
65000,65000110,65000110-010,682,1672,844,828,107Y09M
65000,65000110,65000110-044,561,989,458,531,107Y09M
65000,65000110,65000110-004,169,352,185,167,107Y09M
65000,65000110,65000110-011,643,1703,851,852,107Y09M
65000,65000110,65000110-012,1987,4695,2342,2353,107Y09M
65000,65000110,65000110-050,1402,2930,1429,1501,107Y09M
65000,65000110,65000110-029,3038,7520,3706,3814,107Y09M
65000,65000110,65000110-048,1994,4710,2206,2504,107Y09M
65000,65000110,65000110-047,2381,5464,2529,2935,107Y09M
65000,65000110,65000110-015,2128,5222,2657,2565,107Y09M
65000,65000110,65000110-009,1780,4897,2456,2441,107Y09M
65000,65000110,65000110-016,750,1578,817,761,107Y09M
65000,65000110,65000110-042,2118,5307,2619,2688,107Y09M
65000,65000110,65000110-036,2677,5126,2396,2730,107Y09M
65000,65000110,65000110-008,3307,7250,3335,3915,107Y09M
65000,65000110,65000110-003,2214,4778,2221,2557,107Y09M
65000,65000110,65000110-027,2875,5915,2849,3066,107Y09M
65000,65000110,65000110-049,1429,2709,1249,1460,107Y09M
65000,65000110,65000110-043,2962,6388,3157,3231,107Y09M
65000,65000110,65000110-013,912,2401,1206,1195,107Y09M
65000,65000110,65000110-007,2338,5796,2837,2959,107Y09M
65000,65000110,65000110-001,638,1430,703,727,107Y09M
65000,65000110,65000110-024,1736,3687,1714,1973,107Y09M
65000,65000110,65000110-045,2445,6451,3098,3353,107Y09M
65000,65000110,65000110-034,1476,3280,1563,1717,107Y09M
65000,65000110,65000110-018,958,2222,1179,1043,107Y09M
65000,65000110,65000110-022,2115,4651,2289,2362,107Y09M
65000,65000110,65000110-005,1248,3124,1481,1643,107Y09M
65000,65000110,65000110-035,1420,3093,1479,1614,107Y09M
65000,65000110,65000110-038,544,1271,685,586,107Y09M
65000,65000110,65000110-002,475,1075,524,551,107Y09M
65000,65000200,65000200-005,332,917,522,395,107Y09M
65000,65000200,65000200-003,481,1275,712,563,107Y09M
65000,65000200,65000200-006,279,688,369,319,107Y09M
65000,65000200,65000200-004,199,453,240,213,107Y09M
65000,65000200,65000200-002,481,1445,780,665,107Y09M
65000,65000200,65000200-001,357,920,524,396,107Y09M
65000,65000200,65000200-007,393,859,462,397,107Y09M
65000,65000170,65000170-011,486,1455,772,683,107Y09M
65000,65000170,65000170-005,1633,4542,2276,2266,107Y09M
65000,65000170,65000170-015,2888,7457,3540,3917,107Y09M
65000,65000170,65000170-014,653,1712,851,861,107Y09M
65000,65000170,65000170-003,4067,10173,5052,5121,107Y09M
65000,65000170,65000170-001,1531,4391,2229,2162,107Y09M
65000,65000170,65000170-009,2359,6508,3158,3350,107Y09M
65000,65000170,65000170-002,2187,5904,2921,2983,107Y09M
65000,65000170,65000170-008,9372,20335,9631,10704,107Y09M
65000,65000170,65000170-010,414,1192,642,550,107Y09M
65000,65000170,65000170-006,483,1612,864,748,107Y09M
65000,65000170,65000170-007,9850,22616,10733,11883,107Y09M
65000,65000170,65000170-004,1617,4590,2269,2321,107Y09M
65000,65000170,65000170-013,333,993,538,455,107Y09M
65000,65000170,65000170-012,365,1087,579,508,107Y09M
65000,65000170,65000170-016,3802,9846,4664,5182,107Y09M
65000,65000170,65000170-017,1543,4324,2135,2189,107Y09M
65000,65000010,65000010-058,1084,2966,1424,1542,107Y09M
65000,65000010,65000010-094,1513,4111,2073,2038,107Y09M
65000,65000010,65000010-079,1783,4833,2352,2481,107Y09M
65000,65000010,65000010-125,1332,3844,1881,1963,107Y09M
65000,65000010,65000010-092,2881,6610,3228,3382,107Y09M
65000,65000010,65000010-010,1633,4498,2200,2298,107Y09M
65000,65000010,65000010-123,1582,4316,2166,2150,107Y09M
65000,65000010,65000010-081,1184,3275,1610,1665,107Y09M
65000,65000010,65000010-034,1104,2929,1424,1505,107Y09M
65000,65000010,65000010-026,1256,3247,1540,1707,107Y09M
65000,65000010,65000010-021,1486,4010,1981,2029,107Y09M
65000,65000010,65000010-104,1396,3480,1694,1786,107Y09M
65000,65000010,65000010-119,1437,4040,1958,2082,107Y09M
65000,65000010,65000010-046,1585,4171,2034,2137,107Y09M
65000,65000010,65000010-103,1183,3235,1586,1649,107Y09M
65000,65000010,65000010-108,1116,3181,1514,1667,107Y09M
65000,65000010,65000010-109,920,2332,1094,1238,107Y09M
65000,65000010,65000010-115,852,2177,1033,1144,107Y09M
65000,65000010,65000010-072,1805,5135,2470,2665,107Y09M
65000,65000010,65000010-018,1088,2736,1328,1408,107Y09M
65000,65000010,65000010-062,1408,3614,1759,1855,107Y09M
65000,65000010,65000010-059,2204,5629,2673,2956,107Y09M
65000,65000010,65000010-060,1053,3076,1524,1552,107Y09M
65000,65000010,65000010-053,1370,3482,1764,1718,107Y09M
65000,65000010,65000010-013,1126,2810,1371,1439,107Y09M
65000,65000010,65000010-114,1025,2659,1329,1330,107Y09M
65000,65000010,65000010-036,1366,3900,1910,1990,107Y09M
65000,65000010,65000010-113,2536,6902,3398,3504,107Y09M
65000,65000010,65000010-029,1923,5077,2517,2560,107Y09M
65000,65000010,65000010-025,1145,2839,1347,1492,107Y09M
65000,65000010,65000010-012,1094,2902,1413,1489,107Y09M
65000,65000010,65000010-011,2061,5365,2618,2747,107Y09M
65000,65000010,65000010-067,1074,2893,1413,1480,107Y09M
65000,65000010,65000010-033,2228,4988,2354,2634,107Y09M
65000,65000010,65000010-003,320,827,400,427,107Y09M
65000,65000010,65000010-082,1668,4179,1973,2206,107Y09M
65000,65000010,65000010-120,1242,3414,1685,1729,107Y09M
65000,65000010,65000010-023,1513,4082,2020,2062,107Y09M
65000,65000010,65000010-024,1728,4289,2083,2206,107Y09M
65000,65000010,65000010-044,4463,11009,5190,5819,107Y09M
65000,65000010,65000010-039,1949,4901,2388,2513,107Y09M
65000,65000010,65000010-068,1674,4861,2369,2492,107Y09M
65000,65000010,65000010-122,914,2732,1348,1384,107Y09M
65000,65000010,65000010-118,953,2388,1194,1194,107Y09M
65000,65000010,65000010-040,1376,3477,1678,1799,107Y09M
65000,65000010,65000010-008,5130,9321,5219,4102,107Y09M
65000,65000010,65000010-016,1475,4125,2009,2116,107Y09M
65000,65000010,65000010-069,1741,5028,2430,2598,107Y09M
65000,65000010,65000010-055,1064,2974,1474,1500,107Y09M
65000,65000010,65000010-047,1201,3066,1569,1497,107Y09M
65000,65000010,65000010-088,1732,4385,2159,2226,107Y09M
65000,65000010,65000010-019,1448,3734,1798,1936,107Y09M
65000,65000010,65000010-110,1596,3928,1944,1984,107Y09M
65000,65000010,65000010-041,1795,4313,2044,2269,107Y09M
65000,65000010,65000010-002,642,1567,731,836,107Y09M
65000,65000010,65000010-080,3289,9045,4413,4632,107Y09M
65000,65000010,65000010-066,1481,3980,1915,2065,107Y09M
65000,65000010,65000010-009,1591,4423,2203,2220,107Y09M
65000,65000010,65000010-101,1004,2628,1301,1327,107Y09M
65000,65000010,65000010-054,2580,6445,3064,3381,107Y09M
65000,65000010,65000010-052,1644,4356,2137,2219,107Y09M
65000,65000010,65000010-051,1694,4566,2246,2320,107Y09M
65000,65000010,65000010-057,2865,8508,4045,4463,107Y09M
65000,65000010,65000010-089,1381,3950,1976,1974,107Y09M
65000,65000010,65000010-001,676,1638,780,858,107Y09M
65000,65000010,65000010-030,2098,5605,2715,2890,107Y09M
65000,65000010,65000010-005,798,1876,910,966,107Y09M
65000,65000010,65000010-014,1551,3790,1821,1969,107Y09M
65000,65000010,65000010-073,1454,3809,1810,1999,107Y09M
65000,65000010,65000010-061,1813,4766,2294,2472,107Y09M
65000,65000010,65000010-112,1525,4576,2283,2293,107Y09M
65000,65000010,65000010-098,3757,10453,5122,5331,107Y09M
65000,65000010,65000010-065,3723,9342,4499,4843,107Y09M
65000,65000010,65000010-106,1172,3015,1480,1535,107Y09M
65000,65000010,65000010-121,1636,4436,2139,2297,107Y09M
65000,65000010,65000010-107,863,2354,1138,1216,107Y09M
65000,65000010,65000010-045,972,2546,1277,1269,107Y09M
65000,65000010,65000010-093,312,1092,668,424,107Y09M
65000,65000010,65000010-075,1516,3535,1670,1865,107Y09M
65000,65000010,65000010-117,1267,3509,1670,1839,107Y09M
65000,65000010,65000010-015,1111,3043,1446,1597,107Y09M
65000,65000010,65000010-050,2432,6253,3065,3188,107Y09M
65000,65000010,65000010-017,1942,4990,2449,2541,107Y09M
65000,65000010,65000010-090,1939,5567,2796,2771,107Y09M
65000,65000010,65000010-028,3246,7886,3651,4235,107Y09M
65000,65000010,65000010-087,3338,7714,3739,3975,107Y09M
65000,65000010,65000010-085,1020,2735,1313,1422,107Y09M
65000,65000010,65000010-111,778,2179,1062,1117,107Y09M
65000,65000010,65000010-043,1402,3803,1817,1986,107Y09M
65000,65000010,65000010-086,2979,7382,3528,3854,107Y09M
65000,65000010,65000010-084,1650,4330,2088,2242,107Y09M
65000,65000010,65000010-077,1638,3924,1868,2056,107Y09M
65000,65000010,65000010-116,1057,2837,1389,1448,107Y09M
65000,65000010,65000010-004,429,1135,566,569,107Y09M
65000,65000010,65000010-006,2329,5560,2646,2914,107Y09M
65000,65000010,65000010-022,1740,4626,2280,2346,107Y09M
65000,65000010,65000010-102,1586,4523,2255,2268,107Y09M
65000,65000010,65000010-027,893,2146,1040,1106,107Y09M
65000,65000010,65000010-105,1261,3719,1883,1836,107Y09M
65000,65000010,65000010-035,3102,8077,3881,4196,107Y09M
65000,65000010,65000010-007,1526,3342,1599,1743,107Y09M
65000,65000010,65000010-100,1359,3726,1837,1889,107Y09M
65000,65000010,65000010-099,2199,6250,3046,3204,107Y09M
65000,65000010,65000010-124,5163,15045,7415,7630,107Y09M
65000,65000010,65000010-031,2421,6245,3086,3159,107Y09M
65000,65000010,65000010-091,1529,4367,2171,2196,107Y09M
65000,65000010,65000010-020,1670,4385,2127,2258,107Y09M
65000,65000010,65000010-038,1143,3018,1452,1566,107Y09M
65000,65000010,65000010-070,2251,5074,2343,2731,107Y09M
65000,65000010,65000010-095,2810,6065,2909,3156,107Y09M
65000,65000010,65000010-076,1356,3712,1781,1931,107Y09M
65000,65000010,65000010-071,1601,4115,1918,2197,107Y09M
65000,65000010,65000010-056,1285,3412,1680,1732,107Y09M
65000,65000010,65000010-049,563,1378,690,688,107Y09M
65000,65000010,65000010-074,2011,5366,2685,2681,107Y09M
65000,65000010,65000010-096,2020,5545,2775,2770,107Y09M
65000,65000010,65000010-064,1282,3757,1845,1912,107Y09M
65000,65000010,65000010-083,1560,4281,2083,2198,107Y09M
65000,65000010,65000010-078,2616,7075,3434,3641,107Y09M
65000,65000010,65000010-037,2730,7600,3720,3880,107Y09M
65000,65000010,65000010-097,1086,2981,1453,1528,107Y09M
65000,65000010,65000010-042,2016,5216,2527,2689,107Y09M
65000,65000010,65000010-032,1662,3801,1812,1989,107Y09M
65000,65000010,65000010-063,1598,4425,2125,2300,107Y09M
65000,65000010,65000010-048,2246,6207,3056,3151,107Y09M
65000,65000010,65000010-126,469,1314,682,632,107Y09M
65000,65000270,65000270-010,214,722,342,380,107Y09M
65000,65000270,65000270-002,279,796,382,414,107Y09M
65000,65000270,65000270-006,620,1960,1000,960,107Y09M
65000,65000270,65000270-009,240,774,417,357,107Y09M
65000,65000270,65000270-014,240,642,344,298,107Y09M
65000,65000270,65000270-013,59,209,122,87,107Y09M
65000,65000270,65000270-008,141,465,240,225,107Y09M
65000,65000270,65000270-001,196,544,258,286,107Y09M
65000,65000270,65000270-015,1953,5745,2736,3009,107Y09M
65000,65000270,65000270-005,1420,4563,2170,2393,107Y09M
65000,65000270,65000270-007,565,1336,681,655,107Y09M
65000,65000270,65000270-011,294,942,504,438,107Y09M
65000,65000270,65000270-012,184,537,263,274,107Y09M
65000,65000270,65000270-004,564,2042,1028,1014,107Y09M
65000,65000270,65000270-003,171,568,289,279,107Y09M
65000,65000160,65000160-001,338,986,533,453,107Y09M
65000,65000160,65000160-003,2498,7115,3587,3528,107Y09M
65000,65000160,65000160-017,3810,9841,4794,5047,107Y09M
65000,65000160,65000160-006,1493,4345,2141,2204,107Y09M
65000,65000160,65000160-011,1447,4219,2054,2165,107Y09M
65000,65000160,65000160-008,1360,3862,1902,1960,107Y09M
65000,65000160,65000160-013,798,2301,1115,1186,107Y09M
65000,65000160,65000160-009,1614,4100,2040,2060,107Y09M
65000,65000160,65000160-010,1958,5188,2566,2622,107Y09M
65000,65000160,65000160-015,1526,3888,1911,1977,107Y09M
65000,65000160,65000160-014,1226,3488,1721,1767,107Y09M
65000,65000160,65000160-005,1720,4709,2373,2336,107Y09M
65000,65000160,65000160-012,3273,9021,4483,4538,107Y09M
65000,65000160,65000160-007,1723,4960,2483,2477,107Y09M
65000,65000160,65000160-004,1058,3024,1527,1497,107Y09M
65000,65000160,65000160-016,1423,3887,1899,1988,107Y09M
65000,65000160,65000160-002,1339,3778,1839,1939,107Y09M
65000,65000290,65000290-005,45,252,132,120,107Y09M
65000,65000290,65000290-002,541,1871,921,950,107Y09M
65000,65000290,65000290-004,206,584,280,304,107Y09M
65000,65000290,65000290-001,892,2857,1389,1468,107Y09M
65000,65000290,65000290-003,209,812,409,403,107Y09M
65000,65000260,65000260-007,675,1930,969,961,107Y09M
65000,65000260,65000260-002,239,546,338,208,107Y09M
65000,65000260,65000260-011,350,1094,555,539,107Y09M
65000,65000260,65000260-010,305,806,468,338,107Y09M
65000,65000260,65000260-008,713,2271,1095,1176,107Y09M
65000,65000260,65000260-001,389,953,476,477,107Y09M
65000,65000260,65000260-009,307,953,432,521,107Y09M
65000,65000260,65000260-006,647,1867,921,946,107Y09M
65000,65000260,65000260-005,250,737,364,373,107Y09M
65000,65000260,65000260-004,185,467,268,199,107Y09M
65000,65000260,65000260-003,304,743,417,326,107Y09M
65000,65000100,65000100-020,3145,5819,2613,3206,107Y09M
65000,65000100,65000100-042,3948,7933,3705,4228,107Y09M
65000,65000100,65000100-001,218,633,366,267,107Y09M
65000,65000100,65000100-023,1721,4188,2018,2170,107Y09M
65000,65000100,65000100-002,366,1178,631,547,107Y09M
65000,65000100,65000100-031,810,1907,890,1017,107Y09M
65000,65000100,65000100-013,891,2323,1232,1091,107Y09M
65000,65000100,65000100-011,2297,6108,2965,3143,107Y09M
65000,65000100,65000100-012,4750,10928,5197,5731,107Y09M
65000,65000100,65000100-038,1391,2923,1374,1549,107Y09M
65000,65000100,65000100-037,2080,4826,2188,2638,107Y09M
65000,65000100,65000100-019,3465,7322,3319,4003,107Y09M
65000,65000100,65000100-029,295,769,374,395,107Y09M
65000,65000100,65000100-039,2088,4479,2068,2411,107Y09M
65000,65000100,65000100-028,399,969,478,491,107Y09M
65000,65000100,65000100-018,2974,6328,2852,3476,107Y09M
65000,65000100,65000100-033,1889,4361,2124,2237,107Y09M
65000,65000100,65000100-027,619,1579,783,796,107Y09M
65000,65000100,65000100-016,638,1413,701,712,107Y09M
65000,65000100,65000100-040,1648,4206,2030,2176,107Y09M
65000,65000100,65000100-007,367,923,508,415,107Y09M
65000,65000100,65000100-014,427,1214,685,529,107Y09M
65000,65000100,65000100-032,2363,5638,2733,2905,107Y09M
65000,65000100,65000100-024,646,1507,749,758,107Y09M
65000,65000100,65000100-021,5477,10659,4904,5755,107Y09M
65000,65000100,65000100-008,7502,14894,7157,7737,107Y09M
65000,65000100,65000100-026,353,795,413,382,107Y09M
65000,65000100,65000100-009,795,1814,971,843,107Y09M
65000,65000100,65000100-025,506,1221,624,597,107Y09M
65000,65000100,65000100-036,1999,4919,2351,2568,107Y09M
65000,65000100,65000100-030,232,464,219,245,107Y09M
65000,65000100,65000100-035,3640,9037,4342,4695,107Y09M
65000,65000100,65000100-034,1566,4466,2182,2284,107Y09M
65000,65000100,65000100-010,3272,7678,3566,4112,107Y09M
65000,65000100,65000100-006,1116,2855,1499,1356,107Y09M
65000,65000100,65000100-017,3426,6962,3322,3640,107Y09M
65000,65000100,65000100-003,650,1685,897,788,107Y09M
65000,65000100,65000100-022,2667,6366,2985,3381,107Y09M
65000,65000100,65000100-041,2182,4825,2306,2519,107Y09M
65000,65000100,65000100-015,685,1461,753,708,107Y09M
65000,65000100,65000100-004,688,1677,892,785,107Y09M
65000,65000100,65000100-005,494,1124,632,492,107Y09M
65000,65000180,65000180-003,1184,3127,1574,1553,107Y09M
65000,65000180,65000180-004,787,2183,1146,1037,107Y09M
65000,65000180,65000180-005,226,626,345,281,107Y09M
65000,65000180,65000180-006,2630,6522,3166,3356,107Y09M
65000,65000180,65000180-001,1437,3463,1717,1746,107Y09M
65000,65000180,65000180-002,1097,2542,1275,1267,107Y09M
65000,65000180,65000180-007,1214,2768,1402,1366,107Y09M
65000,65000180,65000180-008,1050,2369,1200,1169,107Y09M
65000,65000060,65000060-013,1400,3419,1751,1668,107Y09M
65000,65000060,65000060-004,1779,4053,1961,2092,107Y09M
65000,65000060,65000060-003,1608,3851,1798,2053,107Y09M
65000,65000060,65000060-010,1275,2743,1330,1413,107Y09M
65000,65000060,65000060-059,1465,3997,1947,2050,107Y09M
65000,65000060,65000060-052,2303,4780,2175,2605,107Y09M
65000,65000060,65000060-054,2658,5887,2743,3144,107Y09M
65000,65000060,65000060-044,2684,6509,3018,3491,107Y09M
65000,65000060,65000060-045,1995,4498,2107,2391,107Y09M
65000,65000060,65000060-037,2320,5325,2512,2813,107Y09M
65000,65000060,65000060-041,3271,7614,3552,4062,107Y09M
65000,65000060,65000060-046,935,2089,967,1122,107Y09M
65000,65000060,65000060-016,4931,12547,6060,6487,107Y09M
65000,65000060,65000060-011,1425,3225,1553,1672,107Y09M
65000,65000060,65000060-034,806,1785,858,927,107Y09M
65000,65000060,65000060-036,1073,2526,1220,1306,107Y09M
65000,65000060,65000060-019,2264,6018,3016,3002,107Y09M
65000,65000060,65000060-067,2190,5947,2868,3079,107Y09M
65000,65000060,65000060-015,1996,5381,2630,2751,107Y09M
65000,65000060,65000060-057,1823,4870,2335,2535,107Y09M
65000,65000060,65000060-056,3168,7919,3845,4074,107Y09M
65000,65000060,65000060-064,2403,5642,2638,3004,107Y09M
65000,65000060,65000060-005,2327,5597,2633,2964,107Y09M
65000,65000060,65000060-047,1644,4068,1895,2173,107Y09M
65000,65000060,65000060-048,1405,3343,1634,1709,107Y09M
65000,65000060,65000060-050,1612,3659,1692,1967,107Y09M
65000,65000060,65000060-053,402,966,475,491,107Y09M
65000,65000060,65000060-026,858,2514,1298,1216,107Y09M
65000,65000060,65000060-009,1298,2827,1348,1479,107Y09M
65000,65000060,65000060-043,1104,2530,1225,1305,107Y09M
65000,65000060,65000060-055,1405,3599,1716,1883,107Y09M
65000,65000060,65000060-002,1759,4035,1905,2130,107Y09M
65000,65000060,65000060-020,2333,6202,2965,3237,107Y09M
65000,65000060,65000060-029,473,1347,708,639,107Y09M
65000,65000060,65000060-065,1147,2575,1208,1367,107Y09M
65000,65000060,65000060-030,2258,5537,2684,2853,107Y09M
65000,65000060,65000060-008,3154,6443,3090,3353,107Y09M
65000,65000060,65000060-061,1341,3182,1493,1689,107Y09M
65000,65000060,65000060-063,1080,2785,1352,1433,107Y09M
65000,65000060,65000060-022,2157,5413,2618,2795,107Y09M
65000,65000060,65000060-060,4747,10924,5292,5632,107Y09M
65000,65000060,65000060-023,2245,5297,2598,2699,107Y09M
65000,65000060,65000060-014,3658,9367,4533,4834,107Y09M
65000,65000060,65000060-033,1132,2690,1312,1378,107Y09M
65000,65000060,65000060-001,1424,3409,1565,1844,107Y09M
65000,65000060,65000060-040,4041,9132,4346,4786,107Y09M
65000,65000060,65000060-032,1105,2175,962,1213,107Y09M
65000,65000060,65000060-025,1340,3236,1529,1707,107Y09M
65000,65000060,65000060-012,722,1781,935,846,107Y09M
65000,65000060,65000060-062,1463,3420,1634,1786,107Y09M
65000,65000060,65000060-069,1249,2717,1254,1463,107Y09M
65000,65000060,65000060-021,360,1073,570,503,107Y09M
65000,65000060,65000060-038,2605,5969,2785,3184,107Y09M
65000,65000060,65000060-042,3782,6565,3418,3147,107Y09M
65000,65000060,65000060-066,1771,4376,2090,2286,107Y09M
65000,65000060,65000060-031,813,1843,907,936,107Y09M
65000,65000060,65000060-039,1217,2777,1300,1477,107Y09M
65000,65000060,65000060-068,1981,3953,1834,2119,107Y09M
65000,65000060,65000060-051,1853,4277,1991,2286,107Y09M
65000,65000060,65000060-049,1669,4072,1909,2163,107Y09M
65000,65000060,65000060-035,416,857,433,424,107Y09M
65000,65000060,65000060-028,601,1412,762,650,107Y09M
65000,65000060,65000060-017,2311,6516,3251,3265,107Y09M
65000,65000060,65000060-027,701,1732,877,855,107Y09M
65000,65000060,65000060-024,311,863,469,394,107Y09M
65000,65000060,65000060-018,2235,6046,3060,2986,107Y09M
65000,65000060,65000060-007,2630,5528,2550,2978,107Y09M
65000,65000060,65000060-058,3217,7435,3593,3842,107Y09M
65000,65000060,65000060-006,2485,5401,2559,2842,107Y09M
65000,65000050,65000050-012,1209,3245,1577,1668,107Y09M
65000,65000050,65000050-075,3493,9504,4397,5107,107Y09M
65000,65000050,65000050-058,1328,3791,1910,1881,107Y09M
65000,65000050,65000050-057,1369,3851,1905,1946,107Y09M
65000,65000050,65000050-014,1705,4775,2347,2428,107Y09M
65000,65000050,65000050-054,3172,9282,4498,4784,107Y09M
65000,65000050,65000050-011,2262,6251,3016,3235,107Y09M
65000,65000050,65000050-053,4497,11351,5479,5872,107Y09M
65000,65000050,65000050-017,1783,4727,2340,2387,107Y09M
65000,65000050,65000050-023,2222,6838,3301,3537,107Y09M
65000,65000050,65000050-051,1219,3058,1508,1550,107Y09M
65000,65000050,65000050-052,1866,4999,2432,2567,107Y09M
65000,65000050,65000050-020,871,2282,1118,1164,107Y09M
65000,65000050,65000050-043,3512,9207,4474,4733,107Y09M
65000,65000050,65000050-028,1043,2793,1349,1444,107Y09M
65000,65000050,65000050-061,1437,3884,1951,1933,107Y09M
65000,65000050,65000050-036,1379,3700,1859,1841,107Y09M
65000,65000050,65000050-022,676,1908,925,983,107Y09M
65000,65000050,65000050-065,1434,3593,1679,1914,107Y09M
65000,65000050,65000050-019,736,1924,940,984,107Y09M
65000,65000050,65000050-010,860,2278,1118,1160,107Y09M
65000,65000050,65000050-055,1857,4901,2357,2544,107Y09M
65000,65000050,65000050-035,1144,3080,1562,1518,107Y09M
65000,65000050,65000050-081,1360,3909,1930,1979,107Y09M
65000,65000050,65000050-032,2135,6356,3032,3324,107Y09M
65000,65000050,65000050-082,1550,4178,2000,2178,107Y09M
65000,65000050,65000050-026,903,2436,1192,1244,107Y09M
65000,65000050,65000050-034,1413,3919,1904,2015,107Y09M
65000,65000050,65000050-076,4698,11945,5670,6275,107Y09M
65000,65000050,65000050-037,1536,4174,2029,2145,107Y09M
65000,65000050,65000050-031,1872,5325,2556,2769,107Y09M
65000,65000050,65000050-059,1868,5105,2453,2652,107Y09M
65000,65000050,65000050-062,2334,6429,3104,3325,107Y09M
65000,65000050,65000050-029,988,2705,1315,1390,107Y09M
65000,65000050,65000050-083,1626,4894,2415,2479,107Y09M
65000,65000050,65000050-084,975,3008,1450,1558,107Y09M
65000,65000050,65000050-044,1643,5102,2479,2623,107Y09M
65000,65000050,65000050-038,2726,7925,3899,4026,107Y09M
65000,65000050,65000050-041,1552,4861,2376,2485,107Y09M
65000,65000050,65000050-004,1810,4733,2284,2449,107Y09M
65000,65000050,65000050-060,1951,5287,2588,2699,107Y09M
65000,65000050,65000050-046,1679,4789,2412,2377,107Y09M
65000,65000050,65000050-071,1804,5313,2573,2740,107Y09M
65000,65000050,65000050-045,2208,5692,2704,2988,107Y09M
65000,65000050,65000050-049,977,2613,1257,1356,107Y09M
65000,65000050,65000050-042,1162,2854,1446,1408,107Y09M
65000,65000050,65000050-015,4643,12262,6058,6204,107Y09M
65000,65000050,65000050-033,1777,5012,2461,2551,107Y09M
65000,65000050,65000050-047,1659,4586,2201,2385,107Y09M
65000,65000050,65000050-007,1908,4983,2427,2556,107Y09M
65000,65000050,65000050-064,3302,7145,3322,3823,107Y09M
65000,65000050,65000050-063,1319,3829,1850,1979,107Y09M
65000,65000050,65000050-073,1444,3996,1904,2092,107Y09M
65000,65000050,65000050-074,1704,4620,2168,2452,107Y09M
65000,65000050,65000050-030,2066,5741,2762,2979,107Y09M
65000,65000050,65000050-027,1971,5494,2692,2802,107Y09M
65000,65000050,65000050-070,2546,6955,3342,3613,107Y09M
65000,65000050,65000050-056,900,2559,1273,1286,107Y09M
65000,65000050,65000050-009,2559,7297,3557,3740,107Y09M
65000,65000050,65000050-069,1085,3090,1559,1531,107Y09M
65000,65000050,65000050-025,2136,5702,2784,2918,107Y09M
65000,65000050,65000050-039,1595,4451,2192,2259,107Y09M
65000,65000050,65000050-008,1679,4778,2307,2471,107Y09M
65000,65000050,65000050-077,1026,2612,1269,1343,107Y09M
65000,65000050,65000050-001,2124,5624,2722,2902,107Y09M
65000,65000050,65000050-003,569,1587,807,780,107Y09M
65000,65000050,65000050-080,920,2598,1295,1303,107Y09M
65000,65000050,65000050-078,1481,3946,1942,2004,107Y09M
65000,65000050,65000050-024,911,2468,1225,1243,107Y09M
65000,65000050,65000050-066,1481,3842,1844,1998,107Y09M
65000,65000050,65000050-021,2656,7512,3721,3791,107Y09M
65000,65000050,65000050-016,2878,4887,2886,2001,107Y09M
65000,65000050,65000050-005,2046,4718,2332,2386,107Y09M
65000,65000050,65000050-072,2185,6157,3107,3050,107Y09M
65000,65000050,65000050-068,1135,2662,1328,1334,107Y09M
65000,65000050,65000050-013,1408,3658,1806,1852,107Y09M
65000,65000050,65000050-002,3832,8773,4287,4486,107Y09M
65000,65000050,65000050-067,857,2532,1249,1283,107Y09M
65000,65000050,65000050-079,870,2338,1105,1233,107Y09M
65000,65000050,65000050-050,3810,9912,4672,5240,107Y09M
65000,65000050,65000050-040,897,2248,1142,1106,107Y09M
65000,65000050,65000050-006,1378,3925,1922,2003,107Y09M
65000,65000050,65000050-048,4483,11784,5792,5992,107Y09M
65000,65000050,65000050-018,2150,6168,3112,3056,107Y09M
65000,65000120,65000120-010,547,1462,796,666,107Y09M
65000,65000120,65000120-016,135,305,177,128,107Y09M
65000,65000120,65000120-007,1600,4217,2082,2135,107Y09M
65000,65000120,65000120-019,237,482,252,230,107Y09M
65000,65000120,65000120-024,109,189,97,92,107Y09M
65000,65000120,65000120-026,182,358,189,169,107Y09M
65000,65000120,65000120-015,145,295,160,135,107Y09M
65000,65000120,65000120-012,1301,3427,1730,1697,107Y09M
65000,65000120,65000120-011,718,1891,1006,885,107Y09M
65000,65000120,65000120-009,717,1917,942,975,107Y09M
65000,65000120,65000120-032,91,294,156,138,107Y09M
65000,65000120,65000120-008,437,1256,656,600,107Y09M
65000,65000120,65000120-029,677,1357,627,730,107Y09M
65000,65000120,65000120-018,224,486,248,238,107Y09M
65000,65000120,65000120-020,172,340,180,160,107Y09M
65000,65000120,65000120-031,684,1445,685,760,107Y09M
65000,65000120,65000120-013,795,2251,1160,1091,107Y09M
65000,65000120,65000120-014,206,506,287,219,107Y09M
65000,65000120,65000120-023,193,388,213,175,107Y09M
65000,65000120,65000120-034,1333,3638,1839,1799,107Y09M
65000,65000120,65000120-030,1082,2238,1093,1145,107Y09M
65000,65000120,65000120-022,185,373,194,179,107Y09M
65000,65000120,65000120-017,73,167,92,75,107Y09M
65000,65000120,65000120-021,103,184,100,84,107Y09M
65000,65000120,65000120-025,101,204,111,93,107Y09M
65000,65000120,65000120-033,261,949,468,481,107Y09M
65000,65000120,65000120-005,598,1504,804,700,107Y09M
65000,65000120,65000120-004,735,1923,930,993,107Y09M
65000,65000120,65000120-006,273,681,341,340,107Y09M
65000,65000120,65000120-001,361,823,402,421,107Y09M
65000,65000120,65000120-002,947,2267,1106,1161,107Y09M
65000,65000120,65000120-003,574,1391,682,709,107Y09M
65000,65000120,65000120-028,252,514,242,272,107Y09M
65000,65000120,65000120-027,133,331,154,177,107Y09M
65000,65000280,65000280-004,1012,3132,1572,1560,107Y09M
65000,65000280,65000280-009,368,1291,634,657,107Y09M
65000,65000280,65000280-010,1444,3173,1590,1583,107Y09M
65000,65000280,65000280-008,179,466,246,220,107Y09M
65000,65000280,65000280-003,1109,3701,1786,1915,107Y09M
65000,65000280,65000280-007,294,725,404,321,107Y09M
65000,65000280,65000280-001,1479,5025,2468,2557,107Y09M
65000,65000280,65000280-002,977,2889,1474,1415,107Y09M
65000,65000280,65000280-005,235,651,354,297,107Y09M
65000,65000280,65000280-006,393,1063,592,471,107Y09M
65000,65000070,65000070-007,1850,5317,2668,2649,107Y09M
65000,65000070,65000070-001,1468,4313,2181,2132,107Y09M
65000,65000070,65000070-002,1515,4243,2096,2147,107Y09M
65000,65000070,65000070-003,1833,5131,2621,2510,107Y09M
65000,65000070,65000070-042,777,2222,1135,1087,107Y09M
65000,65000070,65000070-014,1310,3743,1777,1966,107Y09M
65000,65000070,65000070-035,1953,5963,3024,2939,107Y09M
65000,65000070,65000070-036,1908,5577,2833,2744,107Y09M
65000,65000070,65000070-038,1242,3588,1717,1871,107Y09M
65000,65000070,65000070-039,944,2903,1482,1421,107Y09M
65000,65000070,65000070-034,1914,5479,2673,2806,107Y09M
65000,65000070,65000070-025,774,2320,1206,1114,107Y09M
65000,65000070,65000070-031,1434,4170,2092,2078,107Y09M
65000,65000070,65000070-040,1107,2909,1539,1370,107Y09M
65000,65000070,65000070-041,585,1656,858,798,107Y09M
65000,65000070,65000070-004,1374,3826,1932,1894,107Y09M
65000,65000070,65000070-028,1598,4652,2335,2317,107Y09M
65000,65000070,65000070-023,656,1927,1023,904,107Y09M
65000,65000070,65000070-037,1188,3214,1564,1650,107Y09M
65000,65000070,65000070-015,1421,4098,2048,2050,107Y09M
65000,65000070,65000070-012,592,1780,892,888,107Y09M
65000,65000070,65000070-018,1153,3386,1723,1663,107Y09M
65000,65000070,65000070-020,1812,5098,2520,2578,107Y09M
65000,65000070,65000070-019,2249,6320,3193,3127,107Y09M
65000,65000070,65000070-022,686,1878,1014,864,107Y09M
65000,65000070,65000070-032,1577,4587,2292,2295,107Y09M
65000,65000070,65000070-005,2392,6697,3354,3343,107Y09M
65000,65000070,65000070-024,6552,15652,7503,8149,107Y09M
65000,65000070,65000070-026,4102,9919,4765,5154,107Y09M
65000,65000070,65000070-016,1748,5306,2624,2682,107Y09M
65000,65000070,65000070-017,1967,5491,2734,2757,107Y09M
65000,65000070,65000070-033,2091,6192,3082,3110,107Y09M
65000,65000070,65000070-021,687,2000,1030,970,107Y09M
65000,65000070,65000070-006,2085,5058,2773,2285,107Y09M
65000,65000070,65000070-011,1261,3614,1762,1852,107Y09M
65000,65000070,65000070-027,442,969,492,477,107Y09M
65000,65000070,65000070-009,2038,5441,2672,2769,107Y09M
65000,65000070,65000070-013,538,1201,600,601,107Y09M
65000,65000070,65000070-010,1563,4338,2141,2197,107Y09M
65000,65000070,65000070-030,1480,3795,1788,2007,107Y09M
65000,65000070,65000070-008,1402,3754,1855,1899,107Y09M
65000,65000070,65000070-029,1422,3951,1951,2000,107Y09M
65000,65000250,65000250-005,192,417,245,172,107Y09M
65000,65000250,65000250-007,159,357,197,160,107Y09M
65000,65000250,65000250-009,305,687,390,297,107Y09M
65000,65000250,65000250-010,223,456,266,190,107Y09M
65000,65000250,65000250-008,448,1044,549,495,107Y09M
65000,65000250,65000250-002,196,421,227,194,107Y09M
65000,65000250,65000250-006,713,1718,910,808,107Y09M
65000,65000250,65000250-011,193,395,221,174,107Y09M
65000,65000250,65000250-012,409,1166,595,571,107Y09M
65000,65000250,65000250-004,366,808,451,357,107Y09M
65000,65000250,65000250-003,371,882,482,400,107Y09M
65000,65000250,65000250-001,227,518,262,256,107Y09M
65000,65000140,65000140-024,1947,5708,2789,2919,107Y09M
65000,65000140,65000140-002,2156,6084,2995,3089,107Y09M
65000,65000140,65000140-025,1268,3470,1706,1764,107Y09M
65000,65000140,65000140-003,1497,4314,2138,2176,107Y09M
65000,65000140,65000140-013,864,2305,1129,1176,107Y09M
65000,65000140,65000140-022,1846,5473,2696,2777,107Y09M
65000,65000140,65000140-028,2712,5540,3012,2528,107Y09M
65000,65000140,65000140-027,1967,5723,2838,2885,107Y09M
65000,65000140,65000140-021,3424,9855,4851,5004,107Y09M
65000,65000140,65000140-006,3839,10961,5385,5576,107Y09M
65000,65000140,65000140-001,5297,14408,6889,7519,107Y09M
65000,65000140,65000140-032,1050,2822,1408,1414,107Y09M
65000,65000140,65000140-035,1852,5440,2631,2809,107Y09M
65000,65000140,65000140-017,2467,7291,3496,3795,107Y09M
65000,65000140,65000140-038,1586,4719,2330,2389,107Y09M
65000,65000140,65000140-016,2246,6768,3365,3403,107Y09M
65000,65000140,65000140-019,2291,6114,2973,3141,107Y09M
65000,65000140,65000140-029,1794,5165,2533,2632,107Y09M
65000,65000140,65000140-004,1986,5517,2620,2897,107Y09M
65000,65000140,65000140-037,2635,8000,3849,4151,107Y09M
65000,65000140,65000140-036,1548,4341,2151,2190,107Y09M
65000,65000140,65000140-033,837,2568,1272,1296,107Y09M
65000,65000140,65000140-023,1218,3446,1686,1760,107Y09M
65000,65000140,65000140-031,1797,5391,2681,2710,107Y09M
65000,65000140,65000140-018,1439,4230,2107,2123,107Y09M
65000,65000140,65000140-005,1388,4000,1996,2004,107Y09M
65000,65000140,65000140-012,977,2712,1331,1381,107Y09M
65000,65000140,65000140-030,1151,3164,1566,1598,107Y09M
65000,65000140,65000140-015,2079,6291,3070,3221,107Y09M
65000,65000140,65000140-009,2555,6393,3097,3296,107Y09M
65000,65000140,65000140-026,1159,3208,1555,1653,107Y09M
65000,65000140,65000140-014,1292,3474,1705,1769,107Y09M
65000,65000140,65000140-020,1298,3733,1873,1860,107Y09M
65000,65000140,65000140-010,1189,3334,1628,1706,107Y09M
65000,65000140,65000140-034,1177,3384,1644,1740,107Y09M
65000,65000140,65000140-007,2463,6626,3238,3388,107Y09M
65000,65000140,65000140-011,1270,3490,1747,1743,107Y09M
65000,65000140,65000140-008,2050,5759,2824,2935,107Y09M
65000,65000080,65000080-012,340,1026,550,476,107Y09M
65000,65000080,65000080-011,3009,8672,4410,4262,107Y09M
65000,65000080,65000080-014,1931,5314,2686,2628,107Y09M
65000,65000080,65000080-018,2040,6075,3127,2948,107Y09M
65000,65000080,65000080-005,406,1136,559,577,107Y09M
65000,65000080,65000080-004,1948,4562,2316,2246,107Y09M
65000,65000080,65000080-017,1650,5201,2599,2602,107Y09M
65000,65000080,65000080-008,2882,9120,4524,4596,107Y09M
65000,65000080,65000080-007,631,1791,867,924,107Y09M
65000,65000080,65000080-010,2851,8047,4060,3987,107Y09M
65000,65000080,65000080-002,901,2362,1166,1196,107Y09M
65000,65000080,65000080-013,127,270,151,119,107Y09M
65000,65000080,65000080-001,429,1161,586,575,107Y09M
65000,65000080,65000080-009,1304,3787,1933,1854,107Y09M
65000,65000080,65000080-003,2138,6064,2950,3114,107Y09M
65000,65000080,65000080-020,2596,7409,3600,3809,107Y09M
65000,65000080,65000080-006,213,623,346,277,107Y09M
65000,65000080,65000080-019,1676,4767,2380,2387,107Y09M
65000,65000080,65000080-016,1491,3944,1934,2010,107Y09M
65000,65000080,65000080-015,1658,4902,2472,2430,107Y09M
10018,10018020,10018020-018,623,1950,966,984,107Y09M
10018,10018020,10018020-010,402,942,448,494,107Y09M
10018,10018020,10018020-035,150,317,174,143,107Y09M
10018,10018020,10018020-011,441,987,482,505,107Y09M
10018,10018020,10018020-004,225,549,281,268,107Y09M
10018,10018020,10018020-045,1769,3936,1859,2077,107Y09M
10018,10018020,10018020-028,1614,4116,2053,2063,107Y09M
10018,10018020,10018020-009,287,649,331,318,107Y09M
10018,10018020,10018020-002,364,838,405,433,107Y09M
10018,10018020,10018020-016,1824,4763,2301,2462,107Y09M
10018,10018020,10018020-015,1452,3514,1722,1792,107Y09M
10018,10018020,10018020-008,481,1167,575,592,107Y09M
10018,10018020,10018020-020,312,1023,538,485,107Y09M
10018,10018020,10018020-044,928,1860,836,1024,107Y09M
10018,10018020,10018020-014,2259,6382,3134,3248,107Y09M
10018,10018020,10018020-006,295,606,275,331,107Y09M
10018,10018020,10018020-017,883,2546,1259,1287,107Y09M
10018,10018020,10018020-039,2146,4763,2402,2361,107Y09M
10018,10018020,10018020-032,2185,6067,3116,2951,107Y09M
10018,10018020,10018020-001,273,619,330,289,107Y09M
10018,10018020,10018020-033,1308,3384,1637,1747,107Y09M
10018,10018020,10018020-031,1916,4772,2275,2497,107Y09M
10018,10018020,10018020-023,2358,5493,2616,2877,107Y09M
10018,10018020,10018020-041,2579,7264,3469,3795,107Y09M
10018,10018020,10018020-040,2188,5801,2733,3068,107Y09M
10018,10018020,10018020-043,824,2556,1273,1283,107Y09M
10018,10018020,10018020-012,666,1837,911,926,107Y09M
10018,10018020,10018020-034,1789,4998,2511,2487,107Y09M
10018,10018020,10018020-024,2655,6818,3422,3396,107Y09M
10018,10018020,10018020-030,695,2251,1130,1121,107Y09M
10018,10018020,10018020-029,1761,4488,2215,2273,107Y09M
10018,10018020,10018020-005,502,1274,637,637,107Y09M
10018,10018020,10018020-026,1256,3300,1644,1656,107Y09M
10018,10018020,10018020-027,716,1906,937,969,107Y09M
10018,10018020,10018020-042,3281,8081,3851,4230,107Y09M
10018,10018020,10018020-021,1211,3347,1606,1741,107Y09M
10018,10018020,10018020-013,743,1922,941,981,107Y09M
10018,10018020,10018020-038,1876,6068,2941,3127,107Y09M
10018,10018020,10018020-036,2081,5832,2834,2998,107Y09M
10018,10018020,10018020-019,1632,4670,2280,2390,107Y09M
10018,10018020,10018020-003,349,841,436,405,107Y09M
10018,10018020,10018020-037,2419,7075,3377,3698,107Y09M
10018,10018020,10018020-007,742,1746,806,940,107Y09M
10018,10018020,10018020-022,2545,7346,3539,3807,107Y09M
10018,10018020,10018020-025,232,680,377,303,107Y09M
10018,10018010,10018010-020,2304,6083,2863,3220,107Y09M
10018,10018010,10018010-008,237,547,278,269,107Y09M
10018,10018010,10018010-040,722,2548,1317,1231,107Y09M
10018,10018010,10018010-012,297,746,356,390,107Y09M
10018,10018010,10018010-013,1567,4216,1998,2218,107Y09M
10018,10018010,10018010-018,2122,5813,2711,3102,107Y09M
10018,10018010,10018010-039,1186,3932,2006,1926,107Y09M
10018,10018010,10018010-044,2055,5859,2877,2982,107Y09M
10018,10018010,10018010-032,633,1515,762,753,107Y09M
10018,10018010,10018010-035,424,1127,557,570,107Y09M
10018,10018010,10018010-033,1563,3943,1915,2028,107Y09M
10018,10018010,10018010-023,1269,3447,1654,1793,107Y09M
10018,10018010,10018010-028,1419,4202,2013,2189,107Y09M
10018,10018010,10018010-010,317,817,422,395,107Y09M
10018,10018010,10018010-007,324,758,360,398,107Y09M
10018,10018010,10018010-009,368,877,448,429,107Y09M
10018,10018010,10018010-011,985,1829,1021,808,107Y09M
10018,10018010,10018010-053,2399,6150,3006,3144,107Y09M
10018,10018010,10018010-027,1557,4354,2141,2213,107Y09M
10018,10018010,10018010-005,288,670,344,326,107Y09M
10018,10018010,10018010-022,1153,3352,1643,1709,107Y09M
10018,10018010,10018010-021,2900,7931,3877,4054,107Y09M
10018,10018010,10018010-025,2238,5205,2444,2761,107Y09M
10018,10018010,10018010-045,2596,6420,3199,3221,107Y09M
10018,10018010,10018010-038,1004,3563,1837,1726,107Y09M
10018,10018010,10018010-015,631,1667,839,828,107Y09M
10018,10018010,10018010-003,418,986,489,497,107Y09M
10018,10018010,10018010-001,367,786,384,402,107Y09M
10018,10018010,10018010-037,1839,4394,2214,2180,107Y09M
10018,10018010,10018010-048,1102,3068,1491,1577,107Y09M
10018,10018010,10018010-047,2835,8815,4428,4387,107Y09M
10018,10018010,10018010-036,1489,3586,1746,1840,107Y09M
10018,10018010,10018010-041,2703,6425,3305,3120,107Y09M
10018,10018010,10018010-016,2550,6528,3177,3351,107Y09M
10018,10018010,10018010-030,2252,6154,3005,3149,107Y09M
10018,10018010,10018010-031,2377,6901,3488,3413,107Y09M
10018,10018010,10018010-014,1284,3409,1666,1743,107Y09M
10018,10018010,10018010-019,1952,5486,2621,2865,107Y09M
10018,10018010,10018010-050,2310,6669,3211,3458,107Y09M
10018,10018010,10018010-052,1437,4253,2102,2151,107Y09M
10018,10018010,10018010-049,1432,4055,2005,2050,107Y09M
10018,10018010,10018010-043,2543,6949,3463,3486,107Y09M
10018,10018010,10018010-029,1315,3548,1753,1795,107Y09M
10018,10018010,10018010-006,155,341,169,172,107Y09M
10018,10018010,10018010-002,711,1595,815,780,107Y09M
10018,10018010,10018010-026,3176,8919,4283,4636,107Y09M
10018,10018010,10018010-017,901,2302,1064,1238,107Y09M
10018,10018010,10018010-051,917,2359,1081,1278,107Y09M
10018,10018010,10018010-042,4822,11682,5881,5801,107Y09M
10018,10018010,10018010-024,2250,5915,2879,3036,107Y09M
10018,10018010,10018010-046,2157,6064,2972,3092,107Y09M
10018,10018010,10018010-004,261,562,286,276,107Y09M
10018,10018010,10018010-054,2365,5490,2763,2727,107Y09M
10018,10018030,10018030-013,1108,3380,1694,1686,107Y09M
10018,10018030,10018030-018,304,1025,551,474,107Y09M
10018,10018030,10018030-007,1135,3418,1729,1689,107Y09M
10018,10018030,10018030-020,729,2126,1090,1036,107Y09M
10018,10018030,10018030-021,1637,5278,2643,2635,107Y09M
10018,10018030,10018030-008,2299,5354,2658,2696,107Y09M
10018,10018030,10018030-010,1838,4764,2440,2324,107Y09M
10018,10018030,10018030-002,1974,6270,3222,3048,107Y09M
10018,10018030,10018030-003,898,2760,1354,1406,107Y09M
10018,10018030,10018030-023,288,969,514,455,107Y09M
10018,10018030,10018030-019,317,950,499,451,107Y09M
10018,10018030,10018030-014,404,1294,716,578,107Y09M
10018,10018030,10018030-017,375,1040,540,500,107Y09M
10018,10018030,10018030-012,1822,5313,2618,2695,107Y09M
10018,10018030,10018030-011,1432,4009,2059,1950,107Y09M
10018,10018030,10018030-006,1314,3861,1993,1868,107Y09M
10018,10018030,10018030-004,999,2895,1501,1394,107Y09M
10018,10018030,10018030-016,925,2751,1432,1319,107Y09M
10018,10018030,10018030-009,2664,6175,2988,3187,107Y09M
10018,10018030,10018030-024,1995,5035,2509,2526,107Y09M
10018,10018030,10018030-015,792,2472,1272,1200,107Y09M
10018,10018030,10018030-001,1008,2985,1558,1427,107Y09M
10018,10018030,10018030-005,729,2493,1256,1237,107Y09M
10018,10018030,10018030-022,520,1633,885,748,107Y09M
10004,10004130,10004130-001,600,1693,897,796,107Y09M
10004,10004130,10004130-003,176,451,240,211,107Y09M
10004,10004130,10004130-002,332,866,455,411,107Y09M
10004,10004130,10004130-004,661,1809,985,824,107Y09M
10004,10004090,10004090-006,277,852,462,390,107Y09M
10004,10004090,10004090-007,228,627,355,272,107Y09M
10004,10004090,10004090-004,333,976,552,424,107Y09M
10004,10004090,10004090-001,443,1337,695,642,107Y09M
10004,10004090,10004090-009,151,313,191,122,107Y09M
10004,10004090,10004090-008,144,368,215,153,107Y09M
10004,10004090,10004090-005,137,444,254,190,107Y09M
10004,10004090,10004090-002,478,1388,745,643,107Y09M
10004,10004090,10004090-003,938,3047,1611,1436,107Y09M
10004,10004120,10004120-006,403,1764,926,838,107Y09M
10004,10004120,10004120-007,560,2236,1184,1052,107Y09M
10004,10004120,10004120-004,279,796,428,368,107Y09M
10004,10004120,10004120-003,500,1626,823,803,107Y09M
10004,10004120,10004120-001,281,722,395,327,107Y09M
10004,10004120,10004120-002,389,988,523,465,107Y09M
10004,10004120,10004120-005,478,1535,801,734,107Y09M
10004,10004010,10004010-021,3673,9935,4844,5091,107Y09M
10004,10004010,10004010-019,751,2049,1043,1006,107Y09M
10004,10004010,10004010-017,600,1853,982,871,107Y09M
10004,10004010,10004010-031,2976,8090,4030,4060,107Y09M
10004,10004010,10004010-004,3739,9542,4665,4877,107Y09M
10004,10004010,10004010-030,1533,4403,2111,2292,107Y09M
10004,10004010,10004010-001,3310,8734,4204,4530,107Y09M
10004,10004010,10004010-024,1640,4968,2436,2532,107Y09M
10004,10004010,10004010-028,2299,4714,2332,2382,107Y09M
10004,10004010,10004010-015,797,2518,1284,1234,107Y09M
10004,10004010,10004010-008,3930,11587,5584,6003,107Y09M
10004,10004010,10004010-007,2914,8413,4179,4234,107Y09M
10004,10004010,10004010-009,2730,7136,3601,3535,107Y09M
10004,10004010,10004010-020,638,1869,986,883,107Y09M
10004,10004010,10004010-003,6443,15914,7880,8034,107Y09M
10004,10004010,10004010-006,1282,3658,1898,1760,107Y09M
10004,10004010,10004010-027,3295,7857,3930,3927,107Y09M
10004,10004010,10004010-010,2511,7281,3671,3610,107Y09M
10004,10004010,10004010-018,759,2259,1203,1056,107Y09M
10004,10004010,10004010-002,5444,15133,7363,7770,107Y09M
10004,10004010,10004010-013,750,2306,1218,1088,107Y09M
10004,10004010,10004010-023,378,1219,651,568,107Y09M
10004,10004010,10004010-011,2814,8496,4213,4283,107Y09M
10004,10004010,10004010-022,2691,7046,3574,3472,107Y09M
10004,10004010,10004010-025,2654,7493,3840,3653,107Y09M
10004,10004010,10004010-016,440,1426,744,682,107Y09M
10004,10004010,10004010-014,925,2837,1486,1351,107Y09M
10004,10004010,10004010-005,1420,3336,1697,1639,107Y09M
10004,10004010,10004010-026,1382,3968,1939,2029,107Y09M
10004,10004010,10004010-029,1612,4685,2287,2398,107Y09M
10004,10004010,10004010-012,1624,5344,2760,2584,107Y09M
10004,10004020,10004020-012,1733,4777,2351,2426,107Y09M
10004,10004020,10004020-019,4814,13285,6789,6496,107Y09M
10004,10004020,10004020-015,2709,7825,3899,3926,107Y09M
10004,10004020,10004020-006,3863,11113,5489,5624,107Y09M
10004,10004020,10004020-001,147,368,214,154,107Y09M
10004,10004020,10004020-007,1797,5609,2810,2799,107Y09M
10004,10004020,10004020-020,712,2059,1034,1025,107Y09M
10004,10004020,10004020-021,790,2223,1112,1111,107Y09M
10004,10004020,10004020-014,3242,9608,4763,4845,107Y09M
10004,10004020,10004020-013,1395,4033,2024,2009,107Y09M
10004,10004020,10004020-010,574,1576,817,759,107Y09M
10004,10004020,10004020-024,673,1878,960,918,107Y09M
10004,10004020,10004020-008,322,827,423,404,107Y09M
10004,10004020,10004020-005,1335,3826,1838,1988,107Y09M
10004,10004020,10004020-022,452,1260,639,621,107Y09M
10004,10004020,10004020-018,267,684,389,295,107Y09M
10004,10004020,10004020-017,746,2138,1137,1001,107Y09M
10004,10004020,10004020-004,912,2575,1281,1294,107Y09M
10004,10004020,10004020-009,1402,3648,1837,1811,107Y09M
10004,10004020,10004020-003,154,436,254,182,107Y09M
10004,10004020,10004020-025,212,718,384,334,107Y09M
10004,10004020,10004020-002,208,450,249,201,107Y09M
10004,10004020,10004020-023,2993,8720,4161,4559,107Y09M
10004,10004020,10004020-011,610,1655,849,806,107Y09M
10004,10004020,10004020-016,2060,5093,2677,2416,107Y09M
10004,10004070,10004070-012,427,1257,684,573,107Y09M
10004,10004070,10004070-011,1723,4905,2511,2394,107Y09M
10004,10004070,10004070-007,234,722,402,320,107Y09M
10004,10004070,10004070-001,177,618,344,274,107Y09M
10004,10004070,10004070-009,964,2811,1499,1312,107Y09M
10004,10004070,10004070-008,290,901,482,419,107Y09M
10004,10004070,10004070-004,151,485,277,208,107Y09M
10004,10004070,10004070-005,953,3100,1623,1477,107Y09M
10004,10004070,10004070-003,333,1090,595,495,107Y09M
10004,10004070,10004070-010,616,1835,971,864,107Y09M
10004,10004070,10004070-002,157,473,266,207,107Y09M
10004,10004070,10004070-006,569,1857,971,886,107Y09M
10004,10004110,10004110-005,285,685,390,295,107Y09M
10004,10004110,10004110-002,270,767,441,326,107Y09M
10004,10004110,10004110-003,256,656,368,288,107Y09M
10004,10004110,10004110-001,349,975,530,445,107Y09M
10004,10004110,10004110-004,517,1601,848,753,107Y09M
10004,10004110,10004110-006,413,961,522,439,107Y09M
10004,10004050,10004050-018,1228,3729,1901,1828,107Y09M
10004,10004050,10004050-005,1144,3644,1860,1784,107Y09M
10004,10004050,10004050-016,2828,7327,3596,3731,107Y09M
10004,10004050,10004050-002,372,1029,505,524,107Y09M
10004,10004050,10004050-001,563,1481,716,765,107Y09M
10004,10004050,10004050-007,1088,3387,1804,1583,107Y09M
10004,10004050,10004050-019,1718,5135,2526,2609,107Y09M
10004,10004050,10004050-013,951,2631,1379,1252,107Y09M
10004,10004050,10004050-009,404,1336,735,601,107Y09M
10004,10004050,10004050-008,1251,3895,2044,1851,107Y09M
10004,10004050,10004050-004,2267,6428,3173,3255,107Y09M
10004,10004050,10004050-017,1409,4254,2178,2076,107Y09M
10004,10004050,10004050-020,1829,5000,2479,2521,107Y09M
10004,10004050,10004050-010,1172,3306,1699,1607,107Y09M
10004,10004050,10004050-012,624,1890,987,903,107Y09M
10004,10004050,10004050-011,925,2820,1462,1358,107Y09M
10004,10004050,10004050-003,1577,4811,2403,2408,107Y09M
10004,10004050,10004050-015,1352,3759,1921,1838,107Y09M
10004,10004050,10004050-014,2346,5962,3023,2939,107Y09M
10004,10004050,10004050-006,1898,5789,2892,2897,107Y09M
10004,10004030,10004030-012,953,2753,1482,1271,107Y09M
10004,10004030,10004030-011,647,2137,1143,994,107Y09M
10004,10004030,10004030-004,700,2342,1271,1071,107Y09M
10004,10004030,10004030-001,397,1313,692,621,107Y09M
10004,10004030,10004030-003,1689,4795,2527,2268,107Y09M
10004,10004030,10004030-014,235,736,410,326,107Y09M
10004,10004030,10004030-005,1228,3856,1976,1880,107Y09M
10004,10004030,10004030-015,387,1331,708,623,107Y09M
10004,10004030,10004030-007,938,2907,1510,1397,107Y09M
10004,10004030,10004030-006,661,2084,1131,953,107Y09M
10004,10004030,10004030-013,341,1169,646,523,107Y09M
10004,10004030,10004030-017,182,501,290,211,107Y09M
10004,10004030,10004030-018,265,829,468,361,107Y09M
10004,10004030,10004030-019,222,698,394,304,107Y09M
10004,10004030,10004030-010,451,1234,642,592,107Y09M
10004,10004030,10004030-009,227,680,355,325,107Y09M
10004,10004030,10004030-008,405,1135,563,572,107Y09M
10004,10004030,10004030-016,520,1646,929,717,107Y09M
10004,10004030,10004030-002,314,982,532,450,107Y09M
10004,10004060,10004060-012,539,1746,913,833,107Y09M
10004,10004060,10004060-015,1797,5273,2599,2674,107Y09M
10004,10004060,10004060-007,1225,3825,1986,1839,107Y09M
10004,10004060,10004060-006,272,997,535,462,107Y09M
10004,10004060,10004060-014,1472,4533,2238,2295,107Y09M
10004,10004060,10004060-011,2000,5971,2943,3028,107Y09M
10004,10004060,10004060-016,2609,7549,3763,3786,107Y09M
10004,10004060,10004060-003,696,2070,1155,915,107Y09M
10004,10004060,10004060-002,668,2061,1120,941,107Y09M
10004,10004060,10004060-008,2162,6383,3285,3098,107Y09M
10004,10004060,10004060-010,1049,3190,1614,1576,107Y09M
10004,10004060,10004060-004,991,3182,1699,1483,107Y09M
10004,10004060,10004060-017,1048,3181,1623,1558,107Y09M
10004,10004060,10004060-009,757,2415,1283,1132,107Y09M
10004,10004060,10004060-005,671,2054,1112,942,107Y09M
10004,10004060,10004060-001,426,1209,651,558,107Y09M
10004,10004060,10004060-013,389,1258,687,571,107Y09M
10004,10004080,10004080-011,337,964,506,458,107Y09M
10004,10004080,10004080-010,577,1858,981,877,107Y09M
10004,10004080,10004080-006,416,1062,584,478,107Y09M
10004,10004080,10004080-002,322,980,549,431,107Y09M
10004,10004080,10004080-008,381,1066,582,484,107Y09M
10004,10004080,10004080-003,116,218,149,69,107Y09M
10004,10004080,10004080-009,602,1833,970,863,107Y09M
10004,10004080,10004080-007,194,499,286,213,107Y09M
10004,10004080,10004080-001,1239,3923,2115,1808,107Y09M
10004,10004080,10004080-005,145,391,205,186,107Y09M
10004,10004080,10004080-004,115,233,132,101,107Y09M
10004,10004040,10004040-016,334,941,527,414,107Y09M
10004,10004040,10004040-014,297,902,499,403,107Y09M
10004,10004040,10004040-005,407,1191,641,550,107Y09M
10004,10004040,10004040-006,253,864,484,380,107Y09M
10004,10004040,10004040-004,1439,4346,2210,2136,107Y09M
10004,10004040,10004040-013,190,540,288,252,107Y09M
10004,10004040,10004040-015,600,2094,1098,996,107Y09M
10004,10004040,10004040-002,767,2286,1190,1096,107Y09M
10004,10004040,10004040-019,337,964,553,411,107Y09M
10004,10004040,10004040-021,381,1052,569,483,107Y09M
10004,10004040,10004040-009,482,1564,865,699,107Y09M
10004,10004040,10004040-008,1421,4361,2238,2123,107Y09M
10004,10004040,10004040-001,182,570,300,270,107Y09M
10004,10004040,10004040-011,232,655,365,290,107Y09M
10004,10004040,10004040-007,341,1258,681,577,107Y09M
10004,10004040,10004040-018,277,976,537,439,107Y09M
10004,10004040,10004040-003,284,827,433,394,107Y09M
10004,10004040,10004040-020,341,984,577,407,107Y09M
10004,10004040,10004040-017,222,596,349,247,107Y09M
10004,10004040,10004040-010,217,629,354,275,107Y09M
10004,10004040,10004040-012,413,1087,616,471,107Y09M
10004,10004100,10004100-003,465,1167,657,510,107Y09M
10004,10004100,10004100-002,893,2112,1120,992,107Y09M
10004,10004100,10004100-007,241,630,351,279,107Y09M
10004,10004100,10004100-009,269,643,388,255,107Y09M
10004,10004100,10004100-005,301,958,537,421,107Y09M
10004,10004100,10004100-004,447,1376,751,625,107Y09M
10004,10004100,10004100-010,1204,3053,1607,1446,107Y09M
10004,10004100,10004100-001,1241,3025,1579,1446,107Y09M
10004,10004100,10004100-008,355,909,502,407,107Y09M
10004,10004100,10004100-006,266,841,480,361,107Y09M
10020,10020020,10020020-013,602,1817,940,877,107Y09M
10020,10020020,10020020-015,850,2512,1273,1239,107Y09M
10020,10020020,10020020-058,1158,2520,1242,1278,107Y09M
10020,10020020,10020020-012,1115,3516,1789,1727,107Y09M
10020,10020020,10020020-070,427,1316,686,630,107Y09M
10020,10020020,10020020-003,1000,2725,1371,1354,107Y09M
10020,10020020,10020020-056,981,2308,1142,1166,107Y09M
10020,10020020,10020020-053,2169,6309,3169,3140,107Y09M
10020,10020020,10020020-014,487,1343,687,656,107Y09M
10020,10020020,10020020-009,1971,5139,2489,2650,107Y09M
10020,10020020,10020020-055,768,1997,944,1053,107Y09M
10020,10020020,10020020-017,1425,3957,1954,2003,107Y09M
10020,10020020,10020020-059,1154,2621,1318,1303,107Y09M
10020,10020020,10020020-051,842,2162,1029,1133,107Y09M
10020,10020020,10020020-047,2579,7361,3511,3850,107Y09M
10020,10020020,10020020-069,1869,5137,2516,2621,107Y09M
10020,10020020,10020020-011,1423,3857,1876,1981,107Y09M
10020,10020020,10020020-068,1688,4395,2077,2318,107Y09M
10020,10020020,10020020-046,887,2291,1134,1157,107Y09M
10020,10020020,10020020-064,1008,2555,1274,1281,107Y09M
10020,10020020,10020020-067,654,2080,1057,1023,107Y09M
10020,10020020,10020020-050,1678,4489,2164,2325,107Y09M
10020,10020020,10020020-052,927,2167,988,1179,107Y09M
10020,10020020,10020020-005,876,2408,1227,1181,107Y09M
10020,10020020,10020020-001,307,935,471,464,107Y09M
10020,10020020,10020020-031,995,2281,1142,1139,107Y09M
10020,10020020,10020020-060,699,1561,776,785,107Y09M
10020,10020020,10020020-045,774,1975,931,1044,107Y09M
10020,10020020,10020020-019,1389,4146,2024,2122,107Y09M
10020,10020020,10020020-049,1685,5422,2705,2717,107Y09M
10020,10020020,10020020-002,870,2510,1188,1322,107Y09M
10020,10020020,10020020-061,697,1612,792,820,107Y09M
10020,10020020,10020020-022,941,2483,1238,1245,107Y09M
10020,10020020,10020020-010,1682,5143,2499,2644,107Y09M
10020,10020020,10020020-057,804,1937,941,996,107Y09M
10020,10020020,10020020-066,1226,3393,1587,1806,107Y09M
10020,10020020,10020020-048,2568,7029,3395,3634,107Y09M
10020,10020020,10020020-016,1924,4846,2345,2501,107Y09M
10020,10020020,10020020-065,1799,5076,2427,2649,107Y09M
10020,10020020,10020020-054,777,1705,826,879,107Y09M
10020,10020020,10020020-021,2944,8143,3986,4157,107Y09M
10020,10020020,10020020-063,692,1912,963,949,107Y09M
10020,10020020,10020020-062,766,1855,917,938,107Y09M
10020,10020020,10020020-018,1637,4257,1987,2270,107Y09M
10020,10020020,10020020-020,732,2182,1122,1060,107Y09M
10020,10020010,10020010-061,959,2226,1026,1200,107Y09M
10020,10020010,10020010-062,1052,2605,1289,1316,107Y09M
10020,10020010,10020010-004,1475,3933,1894,2039,107Y09M
10020,10020010,10020010-003,1269,3510,1626,1884,107Y09M
10020,10020010,10020010-039,2001,5308,2468,2840,107Y09M
10020,10020010,10020010-066,1744,4537,2090,2447,107Y09M
10020,10020010,10020010-037,1106,2673,1197,1476,107Y09M
10020,10020010,10020010-064,1026,2658,1276,1382,107Y09M
10020,10020010,10020010-057,944,2122,1092,1030,107Y09M
10020,10020010,10020010-034,1884,4952,2361,2591,107Y09M
10020,10020010,10020010-067,854,2223,1066,1157,107Y09M
10020,10020010,10020010-052,1231,3184,1565,1619,107Y09M
10020,10020010,10020010-038,856,2110,990,1120,107Y09M
10020,10020010,10020010-060,910,2124,996,1128,107Y09M
10020,10020010,10020010-063,1097,3306,1544,1762,107Y09M
10020,10020010,10020010-050,944,2515,1233,1282,107Y09M
10020,10020010,10020010-049,1621,4181,2014,2167,107Y09M
10020,10020010,10020010-043,1293,3453,1703,1750,107Y09M
10020,10020010,10020010-046,613,1562,761,801,107Y09M
10020,10020010,10020010-036,1601,4740,2318,2422,107Y09M
10020,10020010,10020010-002,1449,4214,2011,2203,107Y09M
10020,10020010,10020010-001,1988,5666,2740,2926,107Y09M
10020,10020010,10020010-005,879,2625,1264,1361,107Y09M
10020,10020010,10020010-051,1042,2980,1429,1551,107Y09M
10020,10020010,10020010-042,394,1244,658,586,107Y09M
10020,10020010,10020010-058,888,2351,1192,1159,107Y09M
10020,10020010,10020010-044,1123,2675,1293,1382,107Y09M
10020,10020010,10020010-059,965,2314,1104,1210,107Y09M
10020,10020010,10020010-035,1784,4963,2343,2620,107Y09M
10020,10020010,10020010-045,950,2325,1142,1183,107Y09M
10020,10020010,10020010-068,1186,3385,1686,1699,107Y09M
10020,10020010,10020010-056,988,2559,1235,1324,107Y09M
10020,10020010,10020010-041,780,2236,1116,1120,107Y09M
10020,10020010,10020010-055,1546,4402,2130,2272,107Y09M
10020,10020010,10020010-053,917,2788,1374,1414,107Y09M
10020,10020010,10020010-054,1724,4692,2210,2482,107Y09M
10020,10020010,10020010-047,773,1882,927,955,107Y09M
10020,10020010,10020010-048,599,1520,767,753,107Y09M
10020,10020010,10020010-065,1078,2571,1215,1356,107Y09M
10010,10010040,10010040-021,312,976,512,464,107Y09M
10010,10010040,10010040-020,340,957,480,477,107Y09M
10010,10010040,10010040-016,849,2304,1200,1104,107Y09M
10010,10010040,10010040-014,327,891,475,416,107Y09M
10010,10010040,10010040-011,698,1899,997,902,107Y09M
10010,10010040,10010040-010,87,209,90,119,107Y09M
10010,10010040,10010040-013,548,1432,778,654,107Y09M
10010,10010040,10010040-015,596,1803,922,881,107Y09M
10010,10010040,10010040-019,258,736,400,336,107Y09M
10010,10010040,10010040-004,2664,6977,3378,3599,107Y09M
10010,10010040,10010040-003,457,1130,577,553,107Y09M
10010,10010040,10010040-002,783,2069,1036,1033,107Y09M
10010,10010040,10010040-008,317,801,439,362,107Y09M
10010,10010040,10010040-006,708,2019,1024,995,107Y09M
10010,10010040,10010040-005,433,1338,695,643,107Y09M
10010,10010040,10010040-001,235,567,280,287,107Y09M
10010,10010040,10010040-007,267,657,360,297,107Y09M
10010,10010040,10010040-009,280,700,375,325,107Y09M
10010,10010040,10010040-017,397,1071,559,512,107Y09M
10010,10010040,10010040-018,273,759,404,355,107Y09M
10010,10010040,10010040-012,566,1658,871,787,107Y09M
10010,10010170,10010170-001,733,1696,852,844,107Y09M
10010,10010170,10010170-003,188,505,278,227,107Y09M
10010,10010170,10010170-005,290,625,324,301,107Y09M
10010,10010170,10010170-002,300,723,370,353,107Y09M
10010,10010170,10010170-004,411,1039,541,498,107Y09M
10010,10010130,10010130-019,242,708,383,325,107Y09M
10010,10010130,10010130-001,730,2109,1119,990,107Y09M
10010,10010130,10010130-022,123,332,182,150,107Y09M
10010,10010130,10010130-014,483,1355,702,653,107Y09M
10010,10010130,10010130-016,720,2209,1184,1025,107Y09M
10010,10010130,10010130-018,390,1145,611,534,107Y09M
10010,10010130,10010130-008,3158,7963,3962,4001,107Y09M
10010,10010130,10010130-007,1405,3754,1908,1846,107Y09M
10010,10010130,10010130-009,2483,6452,3244,3208,107Y09M
10010,10010130,10010130-021,136,382,217,165,107Y09M
10010,10010130,10010130-012,813,2446,1315,1131,107Y09M
10010,10010130,10010130-005,568,1690,877,813,107Y09M
10010,10010130,10010130-020,260,857,460,397,107Y09M
10010,10010130,10010130-015,346,1093,597,496,107Y09M
10010,10010130,10010130-006,1189,3254,1700,1554,107Y09M
10010,10010130,10010130-010,746,2145,1143,1002,107Y09M
10010,10010130,10010130-017,251,845,462,383,107Y09M
10010,10010130,10010130-011,559,1711,905,806,107Y09M
10010,10010130,10010130-004,353,983,552,431,107Y09M
10010,10010130,10010130-003,296,948,506,442,107Y09M
10010,10010130,10010130-013,395,1157,637,520,107Y09M
10010,10010130,10010130-002,391,1088,548,540,107Y09M
10010,10010080,10010080-009,292,843,443,400,107Y09M
10010,10010080,10010080-004,107,233,118,115,107Y09M
10010,10010080,10010080-012,407,1047,549,498,107Y09M
10010,10010080,10010080-022,240,607,322,285,107Y09M
10010,10010080,10010080-021,340,816,426,390,107Y09M
10010,10010080,10010080-024,317,739,403,336,107Y09M
10010,10010080,10010080-019,568,1506,821,685,107Y09M
10010,10010080,10010080-016,213,527,265,262,107Y09M
10010,10010080,10010080-015,278,683,366,317,107Y09M
10010,10010080,10010080-025,247,636,352,284,107Y09M
10010,10010080,10010080-023,291,704,376,328,107Y09M
10010,10010080,10010080-013,429,1156,585,571,107Y09M
10010,10010080,10010080-017,298,678,370,308,107Y09M
10010,10010080,10010080-010,306,785,436,349,107Y09M
10010,10010080,10010080-008,265,709,377,332,107Y09M
10010,10010080,10010080-020,259,676,356,320,107Y09M
10010,10010080,10010080-002,360,914,492,422,107Y09M
10010,10010080,10010080-003,369,959,526,433,107Y09M
10010,10010080,10010080-001,512,1308,685,623,107Y09M
10010,10010080,10010080-018,369,994,526,468,107Y09M
10010,10010080,10010080-011,417,1220,643,577,107Y09M
10010,10010080,10010080-007,360,975,526,449,107Y09M
10010,10010080,10010080-014,614,1645,846,799,107Y09M
10010,10010080,10010080-006,486,1341,700,641,107Y09M
10010,10010080,10010080-005,487,1374,728,646,107Y09M
10010,10010010,10010010-001,965,2691,1385,1306,107Y09M
10010,10010010,10010010-016,1251,3703,1898,1805,107Y09M
10010,10010010,10010010-011,317,818,433,385,107Y09M
10010,10010010,10010010-018,1294,3443,1654,1789,107Y09M
10010,10010010,10010010-008,798,2228,1119,1109,107Y09M
10010,10010010,10010010-003,555,1700,921,779,107Y09M
10010,10010010,10010010-015,701,2150,1104,1046,107Y09M
10010,10010010,10010010-002,160,570,293,277,107Y09M
10010,10010010,10010010-004,656,1959,1030,929,107Y09M
10010,10010010,10010010-006,477,1239,666,573,107Y09M
10010,10010010,10010010-017,276,815,449,366,107Y09M
10010,10010010,10010010-007,328,948,498,450,107Y09M
10010,10010010,10010010-005,413,1329,726,603,107Y09M
10010,10010010,10010010-014,1892,5547,2768,2779,107Y09M
10010,10010010,10010010-012,213,627,332,295,107Y09M
10010,10010010,10010010-009,489,1456,768,688,107Y09M
10010,10010010,10010010-013,1375,3991,2021,1970,107Y09M
10010,10010010,10010010-010,1027,2854,1439,1415,107Y09M
10010,10010120,10010120-008,746,2039,1104,935,107Y09M
10010,10010120,10010120-023,372,1098,581,517,107Y09M
10010,10010120,10010120-010,282,739,355,384,107Y09M
10010,10010120,10010120-007,771,2031,1055,976,107Y09M
10010,10010120,10010120-004,760,2410,1262,1148,107Y09M
10010,10010120,10010120-003,598,1770,963,807,107Y09M
10010,10010120,10010120-021,764,2001,1014,987,107Y09M
10010,10010120,10010120-025,469,1288,662,626,107Y09M
10010,10010120,10010120-001,1754,4631,2341,2290,107Y09M
10010,10010120,10010120-002,1027,2864,1475,1389,107Y09M
10010,10010120,10010120-019,1321,3187,1664,1523,107Y09M
10010,10010120,10010120-009,186,508,245,263,107Y09M
10010,10010120,10010120-020,816,2197,1116,1081,107Y09M
10010,10010120,10010120-012,567,1524,775,749,107Y09M
10010,10010120,10010120-022,319,1046,566,480,107Y09M
10010,10010120,10010120-015,817,2303,1194,1109,107Y09M
10010,10010120,10010120-016,837,2210,1083,1127,107Y09M
10010,10010120,10010120-017,764,2091,1059,1032,107Y09M
10010,10010120,10010120-024,478,1399,745,654,107Y09M
10010,10010120,10010120-006,636,1802,933,869,107Y09M
10010,10010120,10010120-005,307,885,492,393,107Y09M
10010,10010120,10010120-014,453,1160,582,578,107Y09M
10010,10010120,10010120-026,333,920,507,413,107Y09M
10010,10010120,10010120-011,176,444,229,215,107Y09M
10010,10010120,10010120-018,1847,4656,2400,2256,107Y09M
10010,10010120,10010120-013,759,2240,1151,1089,107Y09M
10010,10010030,10010030-002,168,412,227,185,107Y09M
10010,10010030,10010030-021,615,1553,816,737,107Y09M
10010,10010030,10010030-013,474,1249,638,611,107Y09M
10010,10010030,10010030-005,699,1898,936,962,107Y09M
10010,10010030,10010030-012,436,1275,640,635,107Y09M
10010,10010030,10010030-015,146,318,173,145,107Y09M
10010,10010030,10010030-017,133,316,161,155,107Y09M
10010,10010030,10010030-019,513,1333,706,627,107Y09M
10010,10010030,10010030-003,869,2467,1237,1230,107Y09M
10010,10010030,10010030-006,380,1012,533,479,107Y09M
10010,10010030,10010030-001,250,692,330,362,107Y09M
10010,10010030,10010030-020,539,1502,811,691,107Y09M
10010,10010030,10010030-014,779,2119,1100,1019,107Y09M
10010,10010030,10010030-018,340,840,443,397,107Y09M
10010,10010030,10010030-011,947,2661,1274,1387,107Y09M
10010,10010030,10010030-016,178,464,254,210,107Y09M
10010,10010030,10010030-023,295,719,392,327,107Y09M
10010,10010030,10010030-010,497,1444,689,755,107Y09M
10010,10010030,10010030-009,360,1086,552,534,107Y09M
10010,10010030,10010030-007,290,818,427,391,107Y09M
10010,10010030,10010030-022,222,586,322,264,107Y09M
10010,10010030,10010030-004,483,1254,614,640,107Y09M
10010,10010030,10010030-008,311,861,444,417,107Y09M
10010,10010050,10010050-013,587,1575,802,773,107Y09M
10010,10010050,10010050-024,990,2653,1384,1269,107Y09M
10010,10010050,10010050-020,1332,4219,2218,2001,107Y09M
10010,10010050,10010050-021,463,1485,783,702,107Y09M
10010,10010050,10010050-009,383,1110,555,555,107Y09M
10010,10010050,10010050-002,680,1884,923,961,107Y09M
10010,10010050,10010050-019,1036,2795,1435,1360,107Y09M
10010,10010050,10010050-022,2161,6195,3103,3092,107Y09M
10010,10010050,10010050-010,308,938,489,449,107Y09M
10010,10010050,10010050-003,1393,4041,2034,2007,107Y09M
10010,10010050,10010050-011,313,988,514,474,107Y09M
10010,10010050,10010050-025,1022,2862,1507,1355,107Y09M
10010,10010050,10010050-006,750,2143,1103,1040,107Y09M
10010,10010050,10010050-001,1057,2695,1397,1298,107Y09M
10010,10010050,10010050-014,199,587,320,267,107Y09M
10010,10010050,10010050-026,684,1999,1052,947,107Y09M
10010,10010050,10010050-027,1272,3330,1645,1685,107Y09M
10010,10010050,10010050-007,558,1658,856,802,107Y09M
10010,10010050,10010050-008,594,1987,1060,927,107Y09M
10010,10010050,10010050-012,1035,2479,1280,1199,107Y09M
10010,10010050,10010050-028,2752,7672,3855,3817,107Y09M
10010,10010050,10010050-018,751,2245,1170,1075,107Y09M
10010,10010050,10010050-005,586,1880,981,899,107Y09M
10010,10010050,10010050-004,873,2557,1261,1296,107Y09M
10010,10010050,10010050-016,752,2172,1131,1041,107Y09M
10010,10010050,10010050-017,1130,3151,1568,1583,107Y09M
10010,10010050,10010050-015,418,1214,619,595,107Y09M
10010,10010050,10010050-023,1041,2816,1452,1364,107Y09M
10010,10010020,10010020-016,1415,3696,1858,1838,107Y09M
10010,10010020,10010020-017,1494,3832,1879,1953,107Y09M
10010,10010020,10010020-006,287,736,361,375,107Y09M
10010,10010020,10010020-015,1050,2248,1016,1232,107Y09M
10010,10010020,10010020-003,468,1322,670,652,107Y09M
10010,10010020,10010020-008,792,2030,1041,989,107Y09M
10010,10010020,10010020-002,1072,2839,1347,1492,107Y09M
10010,10010020,10010020-009,1068,3059,1517,1542,107Y09M
10010,10010020,10010020-001,931,2345,1161,1184,107Y09M
10010,10010020,10010020-019,447,1232,661,571,107Y09M
10010,10010020,10010020-010,1835,5231,2566,2665,107Y09M
10010,10010020,10010020-018,299,890,444,446,107Y09M
10010,10010020,10010020-026,499,1354,728,626,107Y09M
10010,10010020,10010020-027,217,564,298,266,107Y09M
10010,10010020,10010020-020,350,1027,558,469,107Y09M
10010,10010020,10010020-022,306,799,442,357,107Y09M
10010,10010020,10010020-025,427,1186,654,532,107Y09M
10010,10010020,10010020-007,379,1028,516,512,107Y09M
10010,10010020,10010020-004,185,432,219,213,107Y09M
10010,10010020,10010020-005,281,727,352,375,107Y09M
10010,10010020,10010020-021,107,280,153,127,107Y09M
10010,10010020,10010020-024,295,813,402,411,107Y09M
10010,10010020,10010020-011,249,790,409,381,107Y09M
10010,10010020,10010020-013,308,904,485,419,107Y09M
10010,10010020,10010020-023,310,865,467,398,107Y09M
10010,10010020,10010020-014,408,1213,670,543,107Y09M
10010,10010020,10010020-012,273,693,385,308,107Y09M
10010,10010140,10010140-023,354,903,505,398,107Y09M
10010,10010140,10010140-022,115,255,161,94,107Y09M
10010,10010140,10010140-011,577,1821,928,893,107Y09M
10010,10010140,10010140-018,275,734,414,320,107Y09M
10010,10010140,10010140-013,249,717,388,329,107Y09M
10010,10010140,10010140-024,296,782,447,335,107Y09M
10010,10010140,10010140-001,1006,2937,1475,1462,107Y09M
10010,10010140,10010140-003,277,867,458,409,107Y09M
10010,10010140,10010140-004,291,927,498,429,107Y09M
10010,10010140,10010140-002,803,2590,1350,1240,107Y09M
10010,10010140,10010140-012,608,2039,1087,952,107Y09M
10010,10010140,10010140-019,190,487,269,218,107Y09M
10010,10010140,10010140-014,377,1167,654,513,107Y09M
10010,10010140,10010140-009,512,1631,875,756,107Y09M
10010,10010140,10010140-020,621,2189,1188,1001,107Y09M
10010,10010140,10010140-010,482,1639,862,777,107Y09M
10010,10010140,10010140-015,288,994,519,475,107Y09M
10010,10010140,10010140-005,436,1398,756,642,107Y09M
10010,10010140,10010140-007,395,1172,634,538,107Y09M
10010,10010140,10010140-006,215,683,369,314,107Y09M
10010,10010140,10010140-016,213,707,387,320,107Y09M
10010,10010140,10010140-021,367,1016,553,463,107Y09M
10010,10010140,10010140-017,595,2071,1106,965,107Y09M
10010,10010140,10010140-008,2143,5932,3091,2841,107Y09M
10010,10010090,10010090-005,435,1300,702,598,107Y09M
10010,10010090,10010090-010,344,835,461,374,107Y09M
10010,10010090,10010090-006,270,804,416,388,107Y09M
10010,10010090,10010090-018,450,1228,635,593,107Y09M
10010,10010090,10010090-001,798,2215,1120,1095,107Y09M
10010,10010090,10010090-017,312,760,395,365,107Y09M
10010,10010090,10010090-003,522,1540,803,737,107Y09M
10010,10010090,10010090-016,357,945,506,439,107Y09M
10010,10010090,10010090-007,184,424,236,188,107Y09M
10010,10010090,10010090-009,391,1023,544,479,107Y09M
10010,10010090,10010090-011,180,419,229,190,107Y09M
10010,10010090,10010090-015,316,766,425,341,107Y09M
10010,10010090,10010090-021,328,865,446,419,107Y09M
10010,10010090,10010090-022,156,334,207,127,107Y09M
10010,10010090,10010090-013,519,1391,771,620,107Y09M
10010,10010090,10010090-019,404,1013,541,472,107Y09M
10010,10010090,10010090-004,593,1974,1014,960,107Y09M
10010,10010090,10010090-012,440,1091,592,499,107Y09M
10010,10010090,10010090-002,382,1039,528,511,107Y09M
10010,10010090,10010090-020,562,1371,712,659,107Y09M
10010,10010090,10010090-014,360,939,494,445,107Y09M
10010,10010090,10010090-008,391,955,520,435,107Y09M
10010,10010090,10010090-023,494,1442,757,685,107Y09M
10010,10010180,10010180-004,122,344,197,147,107Y09M
10010,10010180,10010180-010,186,617,330,287,107Y09M
10010,10010180,10010180-001,157,419,219,200,107Y09M
10010,10010180,10010180-002,85,211,113,98,107Y09M
10010,10010180,10010180-009,87,288,165,123,107Y09M
10010,10010180,10010180-005,128,368,182,186,107Y09M
10010,10010180,10010180-003,74,162,78,84,107Y09M
10010,10010180,10010180-012,113,301,157,144,107Y09M
10010,10010180,10010180-011,120,353,187,166,107Y09M
10010,10010180,10010180-007,328,990,505,485,107Y09M
10010,10010180,10010180-008,380,1182,592,590,107Y09M
10010,10010180,10010180-006,125,372,213,159,107Y09M
10010,10010150,10010150-009,610,1891,1049,842,107Y09M
10010,10010150,10010150-012,197,545,323,222,107Y09M
10010,10010150,10010150-017,352,1067,596,471,107Y09M
10010,10010150,10010150-014,159,473,267,206,107Y09M
10010,10010150,10010150-007,150,402,204,198,107Y09M
10010,10010150,10010150-006,204,609,318,291,107Y09M
10010,10010150,10010150-008,221,697,378,319,107Y09M
10010,10010150,10010150-005,166,451,266,185,107Y09M
10010,10010150,10010150-011,313,933,528,405,107Y09M
10010,10010150,10010150-004,1803,5101,2601,2500,107Y09M
10010,10010150,10010150-001,964,2589,1309,1280,107Y09M
10010,10010150,10010150-002,403,1034,516,518,107Y09M
10010,10010150,10010150-016,227,706,378,328,107Y09M
10010,10010150,10010150-015,258,835,460,375,107Y09M
10010,10010150,10010150-003,215,586,312,274,107Y09M
10010,10010150,10010150-013,119,321,174,147,107Y09M
10010,10010150,10010150-018,180,434,234,200,107Y09M
10010,10010150,10010150-010,229,643,362,281,107Y09M
10010,10010110,10010110-014,604,1624,823,801,107Y09M
10010,10010110,10010110-015,265,689,357,332,107Y09M
10010,10010110,10010110-008,379,910,522,388,107Y09M
10010,10010110,10010110-009,463,1172,635,537,107Y09M
10010,10010110,10010110-012,375,1033,547,486,107Y09M
10010,10010110,10010110-004,536,1483,769,714,107Y09M
10010,10010110,10010110-011,377,1053,564,489,107Y09M
10010,10010110,10010110-013,520,1335,705,630,107Y09M
10010,10010110,10010110-001,187,575,295,280,107Y09M
10010,10010110,10010110-007,194,483,267,216,107Y09M
10010,10010110,10010110-006,446,1133,606,527,107Y09M
10010,10010110,10010110-002,224,632,349,283,107Y09M
10010,10010110,10010110-003,509,1460,747,713,107Y09M
10010,10010110,10010110-005,236,806,536,270,107Y09M
10010,10010110,10010110-010,436,1054,554,500,107Y09M
10010,10010160,10010160-004,733,2062,1047,1015,107Y09M
10010,10010160,10010160-008,260,709,419,290,107Y09M
10010,10010160,10010160-002,181,470,247,223,107Y09M
10010,10010160,10010160-009,499,1075,594,481,107Y09M
10010,10010160,10010160-010,291,554,340,214,107Y09M
10010,10010160,10010160-006,310,987,537,450,107Y09M
10010,10010160,10010160-001,495,1304,718,586,107Y09M
10010,10010160,10010160-011,149,407,227,180,107Y09M
10010,10010160,10010160-005,308,953,508,445,107Y09M
10010,10010160,10010160-003,500,1500,802,698,107Y09M
10010,10010160,10010160-007,513,1469,766,703,107Y09M
10010,10010070,10010070-016,557,1712,851,861,107Y09M
10010,10010070,10010070-007,596,1845,984,861,107Y09M
10010,10010070,10010070-003,565,1699,839,860,107Y09M
10010,10010070,10010070-006,607,1798,990,808,107Y09M
10010,10010070,10010070-017,420,1215,625,590,107Y09M
10010,10010070,10010070-013,670,1905,1021,884,107Y09M
10010,10010070,10010070-014,566,1810,968,842,107Y09M
10010,10010070,10010070-011,194,563,301,262,107Y09M
10010,10010070,10010070-005,517,1555,816,739,107Y09M
10010,10010070,10010070-023,328,968,517,451,107Y09M
10010,10010070,10010070-019,407,1167,630,537,107Y09M
10010,10010070,10010070-008,356,1093,599,494,107Y09M
10010,10010070,10010070-022,238,639,333,306,107Y09M
10010,10010070,10010070-010,370,1078,580,498,107Y09M
10010,10010070,10010070-021,426,1190,620,570,107Y09M
10010,10010070,10010070-001,925,2661,1381,1280,107Y09M
10010,10010070,10010070-002,606,1811,951,860,107Y09M
10010,10010070,10010070-012,204,547,308,239,107Y09M
10010,10010070,10010070-009,217,642,337,305,107Y09M
10010,10010070,10010070-018,372,1131,583,548,107Y09M
10010,10010070,10010070-015,520,1528,827,701,107Y09M
10010,10010070,10010070-004,615,1904,983,921,107Y09M
10010,10010070,10010070-020,424,1321,686,635,107Y09M
10010,10010060,10010060-010,355,1045,560,485,107Y09M
10010,10010060,10010060-013,278,787,415,372,107Y09M
10010,10010060,10010060-014,352,1024,549,475,107Y09M
10010,10010060,10010060-007,382,928,515,413,107Y09M
10010,10010060,10010060-011,499,1463,788,675,107Y09M
10010,10010060,10010060-009,369,1157,635,522,107Y09M
10010,10010060,10010060-008,451,1264,667,597,107Y09M
10010,10010060,10010060-006,308,874,465,409,107Y09M
10010,10010060,10010060-005,323,769,438,331,107Y09M
10010,10010060,10010060-004,410,1135,606,529,107Y09M
10010,10010060,10010060-003,272,772,413,359,107Y09M
10010,10010060,10010060-002,285,764,418,346,107Y09M
10010,10010060,10010060-001,586,1496,765,731,107Y09M
10010,10010060,10010060-012,439,1192,619,573,107Y09M
10010,10010100,10010100-008,221,466,242,224,107Y09M
10010,10010100,10010100-007,173,414,231,183,107Y09M
10010,10010100,10010100-004,379,973,480,493,107Y09M
10010,10010100,10010100-003,531,1296,662,634,107Y09M
10010,10010100,10010100-012,244,668,344,324,107Y09M
10010,10010100,10010100-010,191,495,275,220,107Y09M
10010,10010100,10010100-015,394,893,447,446,107Y09M
10010,10010100,10010100-016,310,920,474,446,107Y09M
10010,10010100,10010100-017,190,491,247,244,107Y09M
10010,10010100,10010100-001,334,766,401,365,107Y09M
10010,10010100,10010100-019,358,827,437,390,107Y09M
10010,10010100,10010100-014,379,926,496,430,107Y09M
10010,10010100,10010100-020,201,417,235,182,107Y09M
10010,10010100,10010100-011,186,469,254,215,107Y09M
10010,10010100,10010100-009,310,841,442,399,107Y09M
10010,10010100,10010100-005,319,846,432,414,107Y09M
10010,10010100,10010100-013,602,1649,812,837,107Y09M
10010,10010100,10010100-018,237,586,320,266,107Y09M
10010,10010100,10010100-022,307,700,362,338,107Y09M
10010,10010100,10010100-002,653,1676,839,837,107Y09M
10010,10010100,10010100-006,535,1358,740,618,107Y09M
10010,10010100,10010100-021,288,625,349,276,107Y09M
10007,10007180,10007180-007,349,990,526,464,107Y09M
10007,10007180,10007180-017,246,773,423,350,107Y09M
10007,10007180,10007180-002,374,1096,607,489,107Y09M
10007,10007180,10007180-011,291,927,471,456,107Y09M
10007,10007180,10007180-004,269,727,393,334,107Y09M
10007,10007180,10007180-006,403,1108,540,568,107Y09M
10007,10007180,10007180-005,384,1062,523,539,107Y09M
10007,10007180,10007180-001,323,961,517,444,107Y09M
10007,10007180,10007180-013,280,783,417,366,107Y09M
10007,10007180,10007180-015,255,644,351,293,107Y09M
10007,10007180,10007180-012,285,889,449,440,107Y09M
10007,10007180,10007180-016,380,1166,615,551,107Y09M
10007,10007180,10007180-010,364,926,490,436,107Y09M
10007,10007180,10007180-014,255,726,380,346,107Y09M
10007,10007180,10007180-008,190,527,272,255,107Y09M
10007,10007180,10007180-009,403,1167,608,559,107Y09M
10007,10007180,10007180-003,248,725,382,343,107Y09M
10007,10007200,10007200-023,268,1007,534,473,107Y09M
10007,10007200,10007200-005,524,2011,1033,978,107Y09M
10007,10007200,10007200-004,1169,3680,1836,1844,107Y09M
10007,10007200,10007200-008,333,1180,625,555,107Y09M
10007,10007200,10007200-017,511,1736,895,841,107Y09M
10007,10007200,10007200-025,342,1243,617,626,107Y09M
10007,10007200,10007200-003,553,1809,881,928,107Y09M
10007,10007200,10007200-018,441,1446,744,702,107Y09M
10007,10007200,10007200-001,838,2516,1301,1215,107Y09M
10007,10007200,10007200-026,344,1098,555,543,107Y09M
10007,10007200,10007200-021,303,1084,571,513,107Y09M
10007,10007200,10007200-010,579,1926,986,940,107Y09M
10007,10007200,10007200-002,1263,4213,2097,2116,107Y09M
10007,10007200,10007200-011,1244,4023,2001,2022,107Y09M
10007,10007200,10007200-007,374,1203,667,536,107Y09M
10007,10007200,10007200-024,436,1457,728,729,107Y09M
10007,10007200,10007200-015,383,1448,767,681,107Y09M
10007,10007200,10007200-019,347,1207,645,562,107Y09M
10007,10007200,10007200-013,532,1562,851,711,107Y09M
10007,10007200,10007200-027,210,808,429,379,107Y09M
10007,10007200,10007200-020,1247,4099,2119,1980,107Y09M
10007,10007200,10007200-022,381,1328,698,630,107Y09M
10007,10007200,10007200-016,256,908,495,413,107Y09M
10007,10007200,10007200-014,520,1833,986,847,107Y09M
10007,10007200,10007200-006,447,1536,792,744,107Y09M
10007,10007200,10007200-009,383,1342,703,639,107Y09M
10007,10007200,10007200-012,899,3034,1535,1499,107Y09M
10007,10007130,10007130-001,1216,3861,1970,1891,107Y09M
10007,10007130,10007130-013,496,1811,953,858,107Y09M
10007,10007130,10007130-012,690,2327,1198,1129,107Y09M
10007,10007130,10007130-010,487,1691,904,787,107Y09M
10007,10007130,10007130-008,877,2950,1518,1432,107Y09M
10007,10007130,10007130-004,388,1348,704,644,107Y09M
10007,10007130,10007130-011,522,1668,873,795,107Y09M
10007,10007130,10007130-003,475,1653,886,767,107Y09M
10007,10007130,10007130-007,1111,3478,1739,1739,107Y09M
10007,10007130,10007130-002,513,1839,949,890,107Y09M
10007,10007130,10007130-009,479,1766,912,854,107Y09M
10007,10007130,10007130-015,861,2611,1345,1266,107Y09M
10007,10007130,10007130-005,398,1276,678,598,107Y09M
10007,10007130,10007130-006,1109,3332,1639,1693,107Y09M
10007,10007130,10007130-016,721,2382,1253,1129,107Y09M
10007,10007130,10007130-014,842,2908,1533,1375,107Y09M
10007,10007240,10007240-015,246,728,415,313,107Y09M
10007,10007240,10007240-002,364,1231,679,552,107Y09M
10007,10007240,10007240-005,333,1124,592,532,107Y09M
10007,10007240,10007240-007,449,1482,809,673,107Y09M
10007,10007240,10007240-010,403,1179,643,536,107Y09M
10007,10007240,10007240-008,253,796,426,370,107Y09M
10007,10007240,10007240-004,282,992,516,476,107Y09M
10007,10007240,10007240-013,341,1004,539,465,107Y09M
10007,10007240,10007240-003,442,1530,786,744,107Y09M
10007,10007240,10007240-012,405,1405,746,659,107Y09M
10007,10007240,10007240-009,272,753,432,321,107Y09M
10007,10007240,10007240-006,352,1264,690,574,107Y09M
10007,10007240,10007240-011,340,1009,557,452,107Y09M
10007,10007240,10007240-001,447,1222,675,547,107Y09M
10007,10007240,10007240-014,310,1073,559,514,107Y09M
10007,10007190,10007190-005,525,1676,862,814,107Y09M
10007,10007190,10007190-015,663,2027,1027,1000,107Y09M
10007,10007190,10007190-013,735,2301,1145,1156,107Y09M
10007,10007190,10007190-009,452,1559,804,755,107Y09M
10007,10007190,10007190-012,947,3204,1658,1546,107Y09M
10007,10007190,10007190-004,255,785,406,379,107Y09M
10007,10007190,10007190-008,1227,3655,1823,1832,107Y09M
10007,10007190,10007190-001,768,2276,1115,1161,107Y09M
10007,10007190,10007190-011,667,1985,989,996,107Y09M
10007,10007190,10007190-010,1788,5602,2806,2796,107Y09M
10007,10007190,10007190-006,535,1544,786,758,107Y09M
10007,10007190,10007190-007,875,2718,1355,1363,107Y09M
10007,10007190,10007190-003,237,662,350,312,107Y09M
10007,10007190,10007190-014,703,2349,1194,1155,107Y09M
10007,10007190,10007190-002,379,953,455,498,107Y09M
10007,10007160,10007160-010,490,1623,838,785,107Y09M
10007,10007160,10007160-006,539,1718,886,832,107Y09M
10007,10007160,10007160-022,238,786,438,348,107Y09M
10007,10007160,10007160-004,749,2569,1316,1253,107Y09M
10007,10007160,10007160-002,583,1867,942,925,107Y09M
10007,10007160,10007160-001,304,951,473,478,107Y09M
10007,10007160,10007160-003,643,2252,1115,1137,107Y09M
10007,10007160,10007160-014,509,1918,1001,917,107Y09M
10007,10007160,10007160-012,555,1931,976,955,107Y09M
10007,10007160,10007160-020,312,978,524,454,107Y09M
10007,10007160,10007160-019,241,775,413,362,107Y09M
10007,10007160,10007160-024,480,1513,812,701,107Y09M
10007,10007160,10007160-013,649,2245,1163,1082,107Y09M
10007,10007160,10007160-011,389,1442,744,698,107Y09M
10007,10007160,10007160-015,509,1635,863,772,107Y09M
10007,10007160,10007160-018,266,912,466,446,107Y09M
10007,10007160,10007160-017,237,841,436,405,107Y09M
10007,10007160,10007160-005,612,2087,1077,1010,107Y09M
10007,10007160,10007160-007,358,1260,659,601,107Y09M
10007,10007160,10007160-021,287,970,501,469,107Y09M
10007,10007160,10007160-008,338,1271,644,627,107Y09M
10007,10007160,10007160-009,966,3272,1707,1565,107Y09M
10007,10007160,10007160-023,374,1235,664,571,107Y09M
10007,10007160,10007160-016,308,1021,535,486,107Y09M
10007,10007120,10007120-020,556,1861,962,899,107Y09M
10007,10007120,10007120-021,337,1079,584,495,107Y09M
10007,10007120,10007120-015,569,1818,956,862,107Y09M
10007,10007120,10007120-022,315,985,536,449,107Y09M
10007,10007120,10007120-016,466,1510,803,707,107Y09M
10007,10007120,10007120-013,857,2323,1180,1143,107Y09M
10007,10007120,10007120-007,669,2057,1041,1016,107Y09M
10007,10007120,10007120-009,1365,4080,2019,2061,107Y09M
10007,10007120,10007120-005,525,1706,919,787,107Y09M
10007,10007120,10007120-010,979,2865,1420,1445,107Y09M
10007,10007120,10007120-017,582,2144,1086,1058,107Y09M
10007,10007120,10007120-003,308,855,441,414,107Y09M
10007,10007120,10007120-011,449,1247,655,592,107Y09M
10007,10007120,10007120-012,445,1419,697,722,107Y09M
10007,10007120,10007120-001,321,984,513,471,107Y09M
10007,10007120,10007120-019,461,1515,759,756,107Y09M
10007,10007120,10007120-006,456,1535,773,762,107Y09M
10007,10007120,10007120-004,571,1786,933,853,107Y09M
10007,10007120,10007120-018,1514,5108,2582,2526,107Y09M
10007,10007120,10007120-014,902,2765,1439,1326,107Y09M
10007,10007120,10007120-002,330,1263,746,517,107Y09M
10007,10007120,10007120-008,222,693,386,307,107Y09M
10007,10007210,10007210-017,534,1897,992,905,107Y09M
10007,10007210,10007210-011,553,1887,933,954,107Y09M
10007,10007210,10007210-007,414,1375,686,689,107Y09M
10007,10007210,10007210-013,490,2068,1041,1027,107Y09M
10007,10007210,10007210-020,304,1027,533,494,107Y09M
10007,10007210,10007210-001,444,1498,803,695,107Y09M
10007,10007210,10007210-010,448,1563,802,761,107Y09M
10007,10007210,10007210-008,220,746,390,356,107Y09M
10007,10007210,10007210-014,293,1090,574,516,107Y09M
10007,10007210,10007210-016,511,1582,851,731,107Y09M
10007,10007210,10007210-015,285,1003,526,477,107Y09M
10007,10007210,10007210-009,476,1618,815,803,107Y09M
10007,10007210,10007210-018,102,297,151,146,107Y09M
10007,10007210,10007210-006,342,1255,670,585,107Y09M
10007,10007210,10007210-012,419,1418,722,696,107Y09M
10007,10007210,10007210-019,251,714,375,339,107Y09M
10007,10007210,10007210-004,359,1269,660,609,107Y09M
10007,10007210,10007210-005,284,859,470,389,107Y09M
10007,10007210,10007210-002,301,1009,527,482,107Y09M
10007,10007210,10007210-003,954,3150,1556,1594,107Y09M
10007,10007250,10007250-011,226,747,407,340,107Y09M
10007,10007250,10007250-003,264,865,463,402,107Y09M
10007,10007250,10007250-005,503,1801,957,844,107Y09M
10007,10007250,10007250-012,208,647,346,301,107Y09M
10007,10007250,10007250-004,283,881,443,438,107Y09M
10007,10007250,10007250-014,217,617,340,277,107Y09M
10007,10007250,10007250-007,336,1283,673,610,107Y09M
10007,10007250,10007250-001,433,1406,716,690,107Y09M
10007,10007250,10007250-010,281,966,520,446,107Y09M
10007,10007250,10007250-002,730,2403,1191,1212,107Y09M
10007,10007250,10007250-013,304,906,473,433,107Y09M
10007,10007250,10007250-008,405,1283,675,608,107Y09M
10007,10007250,10007250-009,195,565,318,247,107Y09M
10007,10007250,10007250-006,234,766,413,353,107Y09M
10007,10007050,10007050-013,993,3739,1923,1816,107Y09M
10007,10007050,10007050-012,885,3017,1509,1508,107Y09M
10007,10007050,10007050-011,750,2661,1389,1272,107Y09M
10007,10007050,10007050-008,577,2086,1065,1021,107Y09M
10007,10007050,10007050-014,676,2705,1393,1312,107Y09M
10007,10007050,10007050-009,831,3158,1665,1493,107Y09M
10007,10007050,10007050-005,680,2421,1215,1206,107Y09M
10007,10007050,10007050-006,406,1513,771,742,107Y09M
10007,10007050,10007050-007,562,2182,1122,1060,107Y09M
10007,10007050,10007050-003,465,1616,804,812,107Y09M
10007,10007050,10007050-002,385,1339,698,641,107Y09M
10007,10007050,10007050-001,518,2031,1063,968,107Y09M
10007,10007050,10007050-010,1793,6262,3079,3183,107Y09M
10007,10007050,10007050-004,595,2304,1208,1096,107Y09M
10007,10007070,10007070-014,672,2519,1318,1201,107Y09M
10007,10007070,10007070-006,1337,4738,2422,2316,107Y09M
10007,10007070,10007070-002,743,2462,1280,1182,107Y09M
10007,10007070,10007070-001,559,2081,1069,1012,107Y09M
10007,10007070,10007070-013,558,2083,1073,1010,107Y09M
10007,10007070,10007070-004,607,2205,1175,1030,107Y09M
10007,10007070,10007070-011,677,2493,1276,1217,107Y09M
10007,10007070,10007070-005,463,1701,879,822,107Y09M
10007,10007070,10007070-008,743,2639,1390,1249,107Y09M
10007,10007070,10007070-003,883,3231,1648,1583,107Y09M
10007,10007070,10007070-012,548,2004,1032,972,107Y09M
10007,10007070,10007070-009,435,1613,854,759,107Y09M
10007,10007070,10007070-010,1570,5770,2933,2837,107Y09M
10007,10007070,10007070-007,1036,3732,1923,1809,107Y09M
10007,10007030,10007030-011,476,1737,910,827,107Y09M
10007,10007030,10007030-015,1918,6708,3361,3347,107Y09M
10007,10007030,10007030-024,986,3424,1783,1641,107Y09M
10007,10007030,10007030-023,390,1334,735,599,107Y09M
10007,10007030,10007030-032,1120,3333,1602,1731,107Y09M
10007,10007030,10007030-030,1028,3673,1857,1816,107Y09M
10007,10007030,10007030-006,948,3379,1727,1652,107Y09M
10007,10007030,10007030-027,264,1004,527,477,107Y09M
10007,10007030,10007030-031,516,1914,1007,907,107Y09M
10007,10007030,10007030-020,285,1086,545,541,107Y09M
10007,10007030,10007030-001,2284,7499,3745,3754,107Y09M
10007,10007030,10007030-004,715,2260,1127,1133,107Y09M
10007,10007030,10007030-005,1273,3997,2000,1997,107Y09M
10007,10007030,10007030-002,1712,5243,2611,2632,107Y09M
10007,10007030,10007030-003,160,505,234,271,107Y09M
10007,10007030,10007030-013,719,2604,1349,1255,107Y09M
10007,10007030,10007030-019,1181,4272,2185,2087,107Y09M
10007,10007030,10007030-009,712,2663,1342,1321,107Y09M
10007,10007030,10007030-022,835,2767,1397,1370,107Y09M
10007,10007030,10007030-028,401,1383,731,652,107Y09M
10007,10007030,10007030-018,789,2210,1120,1090,107Y09M
10007,10007030,10007030-014,446,1612,850,762,107Y09M
10007,10007030,10007030-026,558,2055,1083,972,107Y09M
10007,10007030,10007030-021,916,2749,1418,1331,107Y09M
10007,10007030,10007030-012,576,2119,1105,1014,107Y09M
10007,10007030,10007030-016,646,2295,1204,1091,107Y09M
10007,10007030,10007030-029,612,2383,1221,1162,107Y09M
10007,10007030,10007030-025,1724,5098,2514,2584,107Y09M
10007,10007030,10007030-007,563,2045,1034,1011,107Y09M
10007,10007030,10007030-008,299,1010,514,496,107Y09M
10007,10007030,10007030-010,970,3348,1729,1619,107Y09M
10007,10007030,10007030-017,940,3065,1579,1486,107Y09M
10007,10007170,10007170-003,402,1343,707,636,107Y09M
10007,10007170,10007170-009,260,866,462,404,107Y09M
10007,10007170,10007170-007,1037,3233,1623,1610,107Y09M
10007,10007170,10007170-015,341,1183,622,561,107Y09M
10007,10007170,10007170-016,368,1166,613,553,107Y09M
10007,10007170,10007170-024,759,2471,1282,1189,107Y09M
10007,10007170,10007170-002,536,1773,907,866,107Y09M
10007,10007170,10007170-022,366,1205,607,598,107Y09M
10007,10007170,10007170-001,1069,3292,1635,1657,107Y09M
10007,10007170,10007170-013,485,1564,822,742,107Y09M
10007,10007170,10007170-012,344,1137,563,574,107Y09M
10007,10007170,10007170-020,348,1130,589,541,107Y09M
10007,10007170,10007170-010,374,1165,585,580,107Y09M
10007,10007170,10007170-017,424,1458,738,720,107Y09M
10007,10007170,10007170-023,411,1434,739,695,107Y09M
10007,10007170,10007170-006,400,1261,659,602,107Y09M
10007,10007170,10007170-011,556,1939,1047,892,107Y09M
10007,10007170,10007170-021,490,1773,913,860,107Y09M
10007,10007170,10007170-014,515,1634,857,777,107Y09M
10007,10007170,10007170-005,331,1096,562,534,107Y09M
10007,10007170,10007170-004,1608,5513,2808,2705,107Y09M
10007,10007170,10007170-008,687,2435,1244,1191,107Y09M
10007,10007170,10007170-018,277,956,515,441,107Y09M
10007,10007170,10007170-019,582,1916,980,936,107Y09M
10007,10007230,10007230-006,788,2569,1314,1255,107Y09M
10007,10007230,10007230-011,332,1129,592,537,107Y09M
10007,10007230,10007230-008,173,534,298,236,107Y09M
10007,10007230,10007230-003,310,860,448,412,107Y09M
10007,10007230,10007230-022,336,1212,665,547,107Y09M
10007,10007230,10007230-015,710,2483,1278,1205,107Y09M
10007,10007230,10007230-018,242,751,390,361,107Y09M
10007,10007230,10007230-007,446,1561,825,736,107Y09M
10007,10007230,10007230-017,261,825,416,409,107Y09M
10007,10007230,10007230-002,182,468,260,208,107Y09M
10007,10007230,10007230-001,362,1076,567,509,107Y09M
10007,10007230,10007230-004,226,633,351,282,107Y09M
10007,10007230,10007230-023,694,2435,1304,1131,107Y09M
10007,10007230,10007230-005,360,1164,584,580,107Y09M
10007,10007230,10007230-021,485,1637,880,757,107Y09M
10007,10007230,10007230-024,238,864,462,402,107Y09M
10007,10007230,10007230-013,222,643,351,292,107Y09M
10007,10007230,10007230-016,241,802,409,393,107Y09M
10007,10007230,10007230-025,426,1622,869,753,107Y09M
10007,10007230,10007230-014,331,889,515,374,107Y09M
10007,10007230,10007230-020,580,1956,1015,941,107Y09M
10007,10007230,10007230-009,234,729,395,334,107Y09M
10007,10007230,10007230-010,256,816,433,383,107Y09M
10007,10007230,10007230-026,1034,3771,1959,1812,107Y09M
10007,10007230,10007230-012,222,639,344,295,107Y09M
10007,10007230,10007230-019,441,1484,784,700,107Y09M
10007,10007080,10007080-016,657,2284,1152,1132,107Y09M
10007,10007080,10007080-007,284,847,427,420,107Y09M
10007,10007080,10007080-003,816,2806,1440,1366,107Y09M
10007,10007080,10007080-010,1161,3480,1769,1711,107Y09M
10007,10007080,10007080-008,666,2096,1111,985,107Y09M
10007,10007080,10007080-017,687,2243,1131,1112,107Y09M
10007,10007080,10007080-011,1742,5286,2698,2588,107Y09M
10007,10007080,10007080-012,475,1546,840,706,107Y09M
10007,10007080,10007080-001,1280,3948,2004,1944,107Y09M
10007,10007080,10007080-002,661,2097,1073,1024,107Y09M
10007,10007080,10007080-009,1820,6112,3129,2983,107Y09M
10007,10007080,10007080-018,533,1906,985,921,107Y09M
10007,10007080,10007080-006,704,2162,1089,1073,107Y09M
10007,10007080,10007080-005,464,1661,880,781,107Y09M
10007,10007080,10007080-004,413,1251,655,596,107Y09M
10007,10007080,10007080-013,1194,4071,2033,2038,107Y09M
10007,10007080,10007080-015,332,1099,602,497,107Y09M
10007,10007080,10007080-014,317,1043,528,515,107Y09M
10007,10007090,10007090-014,364,1159,610,549,107Y09M
10007,10007090,10007090-002,451,1660,877,783,107Y09M
10007,10007090,10007090-013,326,990,529,461,107Y09M
10007,10007090,10007090-012,394,1381,734,647,107Y09M
10007,10007090,10007090-009,233,735,386,349,107Y09M
10007,10007090,10007090-003,572,2091,1092,999,107Y09M
10007,10007090,10007090-004,856,2850,1468,1382,107Y09M
10007,10007090,10007090-007,296,1069,551,518,107Y09M
10007,10007090,10007090-005,802,2708,1438,1270,107Y09M
10007,10007090,10007090-011,321,1164,602,562,107Y09M
10007,10007090,10007090-015,185,681,382,299,107Y09M
10007,10007090,10007090-010,563,1926,1007,919,107Y09M
10007,10007090,10007090-006,554,1872,989,883,107Y09M
10007,10007090,10007090-008,362,1317,711,606,107Y09M
10007,10007090,10007090-001,562,1982,1028,954,107Y09M
10007,10007100,10007100-039,974,2991,1442,1549,107Y09M
10007,10007100,10007100-018,2513,7867,3883,3984,107Y09M
10007,10007100,10007100-038,974,2900,1386,1514,107Y09M
10007,10007100,10007100-017,1087,3312,1635,1677,107Y09M
10007,10007100,10007100-037,1118,3488,1669,1819,107Y09M
10007,10007100,10007100-011,1009,3169,1624,1545,107Y09M
10007,10007100,10007100-019,1097,3555,1741,1814,107Y09M
10007,10007100,10007100-023,798,2873,1484,1389,107Y09M
10007,10007100,10007100-016,730,2787,1402,1385,107Y09M
10007,10007100,10007100-022,1199,3818,1936,1882,107Y09M
10007,10007100,10007100-030,240,851,432,419,107Y09M
10007,10007100,10007100-008,256,710,362,348,107Y09M
10007,10007100,10007100-020,716,2255,1128,1127,107Y09M
10007,10007100,10007100-003,1413,4000,1934,2066,107Y09M
10007,10007100,10007100-035,635,2058,1100,958,107Y09M
10007,10007100,10007100-004,1085,3157,1524,1633,107Y09M
10007,10007100,10007100-040,556,1793,878,915,107Y09M
10007,10007100,10007100-028,583,1938,1024,914,107Y09M
10007,10007100,10007100-002,1168,3245,1586,1659,107Y09M
10007,10007100,10007100-007,353,978,510,468,107Y09M
10007,10007100,10007100-033,678,2456,1262,1194,107Y09M
10007,10007100,10007100-006,1216,3451,1617,1834,107Y09M
10007,10007100,10007100-041,939,2767,1343,1424,107Y09M
10007,10007100,10007100-036,761,2815,1446,1369,107Y09M
10007,10007100,10007100-001,457,1231,594,637,107Y09M
10007,10007100,10007100-027,924,3315,1705,1610,107Y09M
10007,10007100,10007100-013,2093,6437,3072,3365,107Y09M
10007,10007100,10007100-034,632,2086,1064,1022,107Y09M
10007,10007100,10007100-014,1752,5793,2855,2938,107Y09M
10007,10007100,10007100-026,997,3149,1616,1533,107Y09M
10007,10007100,10007100-032,779,2674,1379,1295,107Y09M
10007,10007100,10007100-025,843,2834,1436,1398,107Y09M
10007,10007100,10007100-010,2365,6698,3218,3480,107Y09M
10007,10007100,10007100-029,391,1370,738,632,107Y09M
10007,10007100,10007100-012,1734,5242,2550,2692,107Y09M
10007,10007100,10007100-005,297,884,437,447,107Y09M
10007,10007100,10007100-015,627,2171,1152,1019,107Y09M
10007,10007100,10007100-021,874,2761,1373,1388,107Y09M
10007,10007100,10007100-024,1403,4357,2197,2160,107Y09M
10007,10007100,10007100-009,801,2144,1078,1066,107Y09M
10007,10007100,10007100-031,697,2337,1201,1136,107Y09M
10007,10007150,10007150-017,473,1593,840,753,107Y09M
10007,10007150,10007150-010,222,697,374,323,107Y09M
10007,10007150,10007150-011,423,1451,730,721,107Y09M
10007,10007150,10007150-008,731,2445,1274,1171,107Y09M
10007,10007150,10007150-006,708,2214,1135,1079,107Y09M
10007,10007150,10007150-005,643,2023,1033,990,107Y09M
10007,10007150,10007150-007,489,1662,847,815,107Y09M
10007,10007150,10007150-016,648,2138,1096,1042,107Y09M
10007,10007150,10007150-001,1302,4307,2172,2135,107Y09M
10007,10007150,10007150-004,439,1457,762,695,107Y09M
10007,10007150,10007150-013,380,1230,625,605,107Y09M
10007,10007150,10007150-002,430,1480,799,681,107Y09M
10007,10007150,10007150-019,274,869,467,402,107Y09M
10007,10007150,10007150-020,307,1064,541,523,107Y09M
10007,10007150,10007150-018,334,1042,564,478,107Y09M
10007,10007150,10007150-014,343,1165,620,545,107Y09M
10007,10007150,10007150-009,894,2701,1373,1328,107Y09M
10007,10007150,10007150-003,613,1833,908,925,107Y09M
10007,10007150,10007150-012,548,1821,903,918,107Y09M
10007,10007150,10007150-015,488,1551,806,745,107Y09M
10007,10007140,10007140-003,419,1480,776,704,107Y09M
10007,10007140,10007140-021,449,1538,802,736,107Y09M
10007,10007140,10007140-013,419,1416,744,672,107Y09M
10007,10007140,10007140-018,311,990,534,456,107Y09M
10007,10007140,10007140-019,513,1785,940,845,107Y09M
10007,10007140,10007140-004,308,1099,561,538,107Y09M
10007,10007140,10007140-006,308,1078,570,508,107Y09M
10007,10007140,10007140-015,345,1265,688,577,107Y09M
10007,10007140,10007140-016,270,1021,552,469,107Y09M
10007,10007140,10007140-010,397,1450,751,699,107Y09M
10007,10007140,10007140-017,439,1654,894,760,107Y09M
10007,10007140,10007140-011,606,2076,1068,1008,107Y09M
10007,10007140,10007140-012,592,2445,1290,1155,107Y09M
10007,10007140,10007140-009,225,770,400,370,107Y09M
10007,10007140,10007140-005,550,1991,1055,936,107Y09M
10007,10007140,10007140-022,424,1531,826,705,107Y09M
10007,10007140,10007140-002,553,1845,947,898,107Y09M
10007,10007140,10007140-001,584,2042,1052,990,107Y09M
10007,10007140,10007140-008,374,1257,639,618,107Y09M
10007,10007140,10007140-020,466,1797,928,869,107Y09M
10007,10007140,10007140-014,143,487,257,230,107Y09M
10007,10007140,10007140-007,447,1524,835,689,107Y09M
10007,10007220,10007220-017,339,1090,570,520,107Y09M
10007,10007220,10007220-015,514,1722,871,851,107Y09M
10007,10007220,10007220-010,190,663,343,320,107Y09M
10007,10007220,10007220-008,819,2705,1374,1331,107Y09M
10007,10007220,10007220-006,522,1915,988,927,107Y09M
10007,10007220,10007220-007,1244,3994,1990,2004,107Y09M
10007,10007220,10007220-014,404,1300,676,624,107Y09M
10007,10007220,10007220-016,359,1230,645,585,107Y09M
10007,10007220,10007220-001,878,2928,1490,1438,107Y09M
10007,10007220,10007220-011,527,1769,937,832,107Y09M
10007,10007220,10007220-003,540,1906,1013,893,107Y09M
10007,10007220,10007220-005,475,1572,788,784,107Y09M
10007,10007220,10007220-009,248,861,443,418,107Y09M
10007,10007220,10007220-013,303,922,506,416,107Y09M
10007,10007220,10007220-012,357,1188,642,546,107Y09M
10007,10007220,10007220-004,774,2718,1456,1262,107Y09M
10007,10007220,10007220-002,620,2072,1091,981,107Y09M
10007,10007020,10007020-001,470,1391,709,682,107Y09M
10007,10007020,10007020-025,970,3652,1907,1745,107Y09M
10007,10007020,10007020-002,218,586,299,287,107Y09M
10007,10007020,10007020-029,1760,5455,2699,2756,107Y09M
10007,10007020,10007020-011,415,1395,708,687,107Y09M
10007,10007020,10007020-008,1516,5391,2718,2673,107Y09M
10007,10007020,10007020-006,1755,6413,3290,3123,107Y09M
10007,10007020,10007020-014,110,350,171,179,107Y09M
10007,10007020,10007020-028,798,2864,1487,1377,107Y09M
10007,10007020,10007020-003,350,978,510,468,107Y09M
10007,10007020,10007020-007,1886,6230,3128,3102,107Y09M
10007,10007020,10007020-013,478,1521,713,808,107Y09M
10007,10007020,10007020-026,1185,4282,2176,2106,107Y09M
10007,10007020,10007020-023,1029,3797,1948,1849,107Y09M
10007,10007020,10007020-009,209,638,345,293,107Y09M
10007,10007020,10007020-005,2832,9850,4936,4914,107Y09M
10007,10007020,10007020-019,1284,4777,2424,2353,107Y09M
10007,10007020,10007020-012,460,1300,647,653,107Y09M
10007,10007020,10007020-017,321,1164,571,593,107Y09M
10007,10007020,10007020-018,833,2786,1366,1420,107Y09M
10007,10007020,10007020-027,646,2368,1254,1114,107Y09M
10007,10007020,10007020-004,396,1083,558,525,107Y09M
10007,10007020,10007020-010,330,1015,537,478,107Y09M
10007,10007020,10007020-022,1271,5137,2626,2511,107Y09M
10007,10007020,10007020-021,1238,4897,2540,2357,107Y09M
10007,10007020,10007020-016,218,746,384,362,107Y09M
10007,10007020,10007020-024,664,2584,1324,1260,107Y09M
10007,10007020,10007020-020,757,3209,1631,1578,107Y09M
10007,10007020,10007020-015,259,859,430,429,107Y09M
10007,10007260,10007260-016,419,1460,755,705,107Y09M
10007,10007260,10007260-019,292,1023,552,471,107Y09M
10007,10007260,10007260-015,631,2182,1203,979,107Y09M
10007,10007260,10007260-004,488,1772,900,872,107Y09M
10007,10007260,10007260-008,366,1015,531,484,107Y09M
10007,10007260,10007260-006,481,1776,939,837,107Y09M
10007,10007260,10007260-012,636,2150,1152,998,107Y09M
10007,10007260,10007260-009,684,2399,1280,1119,107Y09M
10007,10007260,10007260-005,249,834,436,398,107Y09M
10007,10007260,10007260-014,681,2181,1116,1065,107Y09M
10007,10007260,10007260-017,724,2296,1164,1132,107Y09M
10007,10007260,10007260-003,387,1390,713,677,107Y09M
10007,10007260,10007260-010,249,818,432,386,107Y09M
10007,10007260,10007260-013,303,991,535,456,107Y09M
10007,10007260,10007260-011,645,1792,921,871,107Y09M
10007,10007260,10007260-001,654,2146,1108,1038,107Y09M
10007,10007260,10007260-018,327,958,497,461,107Y09M
10007,10007260,10007260-007,306,977,511,466,107Y09M
10007,10007260,10007260-002,471,1638,814,824,107Y09M
10007,10007110,10007110-010,985,2991,1520,1471,107Y09M
10007,10007110,10007110-007,1230,4235,2111,2124,107Y09M
10007,10007110,10007110-022,496,1619,851,768,107Y09M
10007,10007110,10007110-014,804,2846,1462,1384,107Y09M
10007,10007110,10007110-015,270,1004,496,508,107Y09M
10007,10007110,10007110-003,748,2505,1229,1276,107Y09M
10007,10007110,10007110-008,487,1686,879,807,107Y09M
10007,10007110,10007110-002,263,755,382,373,107Y09M
10007,10007110,10007110-012,299,982,495,487,107Y09M
10007,10007110,10007110-001,468,1517,770,747,107Y09M
10007,10007110,10007110-004,183,525,257,268,107Y09M
10007,10007110,10007110-024,762,2605,1333,1272,107Y09M
10007,10007110,10007110-017,645,2191,1116,1075,107Y09M
10007,10007110,10007110-006,758,2840,1437,1403,107Y09M
10007,10007110,10007110-009,1109,3692,1863,1829,107Y09M
10007,10007110,10007110-020,419,1496,766,730,107Y09M
10007,10007110,10007110-016,451,1590,807,783,107Y09M
10007,10007110,10007110-005,1273,4347,2185,2162,107Y09M
10007,10007110,10007110-013,609,2128,1076,1052,107Y09M
10007,10007110,10007110-019,242,756,394,362,107Y09M
10007,10007110,10007110-011,889,2721,1348,1373,107Y09M
10007,10007110,10007110-018,1736,5956,2997,2959,107Y09M
10007,10007110,10007110-025,580,2129,1081,1048,107Y09M
10007,10007110,10007110-021,244,821,425,396,107Y09M
10007,10007110,10007110-023,444,1465,763,702,107Y09M
10007,10007010,10007010-057,354,1382,699,683,107Y09M
10007,10007010,10007010-002,2063,6628,3234,3394,107Y09M
10007,10007010,10007010-035,470,1132,587,545,107Y09M
10007,10007010,10007010-050,1232,3934,1982,1952,107Y09M
10007,10007010,10007010-011,342,959,475,484,107Y09M
10007,10007010,10007010-017,360,845,419,426,107Y09M
10007,10007010,10007010-012,671,1746,842,904,107Y09M
10007,10007010,10007010-056,994,2930,1455,1475,107Y09M
10007,10007010,10007010-024,1724,5199,2485,2714,107Y09M
10007,10007010,10007010-046,1369,2966,1480,1486,107Y09M
10007,10007010,10007010-001,578,1601,763,838,107Y09M
10007,10007010,10007010-054,946,3383,1746,1637,107Y09M
10007,10007010,10007010-063,883,2847,1445,1402,107Y09M
10007,10007010,10007010-071,1609,5150,2618,2532,107Y09M
10007,10007010,10007010-031,1598,4966,2427,2539,107Y09M
10007,10007010,10007010-005,617,1812,871,941,107Y09M
10007,10007010,10007010-019,486,1298,655,643,107Y09M
10007,10007010,10007010-036,556,1391,708,683,107Y09M
10007,10007010,10007010-013,405,1041,531,510,107Y09M
10007,10007010,10007010-069,276,1073,568,505,107Y09M
10007,10007010,10007010-066,367,1332,705,627,107Y09M
10007,10007010,10007010-045,642,1720,835,885,107Y09M
10007,10007010,10007010-014,321,842,420,422,107Y09M
10007,10007010,10007010-015,351,841,410,431,107Y09M
10007,10007010,10007010-073,2130,6652,3200,3452,107Y09M
10007,10007010,10007010-052,764,2336,1188,1148,107Y09M
10007,10007010,10007010-040,636,1768,862,906,107Y09M
10007,10007010,10007010-051,627,1974,1031,943,107Y09M
10007,10007010,10007010-068,286,957,514,443,107Y09M
10007,10007010,10007010-043,1221,3370,1595,1775,107Y09M
10007,10007010,10007010-021,1474,4556,2199,2357,107Y09M
10007,10007010,10007010-020,1370,4041,2026,2015,107Y09M
10007,10007010,10007010-070,401,1292,653,639,107Y09M
10007,10007010,10007010-033,1076,2904,1424,1480,107Y09M
10007,10007010,10007010-065,1052,3355,1679,1676,107Y09M
10007,10007010,10007010-047,3626,11220,5432,5788,107Y09M
10007,10007010,10007010-041,1922,6143,3028,3115,107Y09M
10007,10007010,10007010-022,510,1472,722,750,107Y09M
10007,10007010,10007010-023,1301,3840,1867,1973,107Y09M
10007,10007010,10007010-026,1281,4234,2162,2072,107Y09M
10007,10007010,10007010-034,708,1825,888,937,107Y09M
10007,10007010,10007010-025,467,1184,595,589,107Y09M
10007,10007010,10007010-062,3389,10490,5181,5309,107Y09M
10007,10007010,10007010-004,408,1022,479,543,107Y09M
10007,10007010,10007010-027,725,2614,1327,1287,107Y09M
10007,10007010,10007010-028,623,2155,1089,1066,107Y09M
10007,10007010,10007010-042,2886,8881,4257,4624,107Y09M
10007,10007010,10007010-039,3049,9096,4398,4698,107Y09M
10007,10007010,10007010-048,987,2815,1390,1425,107Y09M
10007,10007010,10007010-061,1074,3688,1822,1866,107Y09M
10007,10007010,10007010-060,322,1115,577,538,107Y09M
10007,10007010,10007010-053,1186,3901,2010,1891,107Y09M
10007,10007010,10007010-032,876,2965,1540,1425,107Y09M
10007,10007010,10007010-058,835,2897,1477,1420,107Y09M
10007,10007010,10007010-072,2235,6290,3055,3235,107Y09M
10007,10007010,10007010-018,363,966,478,488,107Y09M
10007,10007010,10007010-064,1704,5234,2624,2610,107Y09M
10007,10007010,10007010-038,702,1722,815,907,107Y09M
10007,10007010,10007010-037,780,2126,1045,1081,107Y09M
10007,10007010,10007010-006,760,2150,1097,1053,107Y09M
10007,10007010,10007010-029,1193,3582,1780,1802,107Y09M
10007,10007010,10007010-009,687,2171,1069,1102,107Y09M
10007,10007010,10007010-008,2153,6659,3208,3451,107Y09M
10007,10007010,10007010-007,1615,4976,2340,2636,107Y09M
10007,10007010,10007010-016,401,1025,509,516,107Y09M
10007,10007010,10007010-044,1235,3464,1642,1822,107Y09M
10007,10007010,10007010-055,2495,8002,4012,3990,107Y09M
10007,10007010,10007010-067,410,1449,737,712,107Y09M
10007,10007010,10007010-049,409,1165,568,597,107Y09M
10007,10007010,10007010-030,1079,3948,1977,1971,107Y09M
10007,10007010,10007010-003,762,2106,990,1116,107Y09M
10007,10007010,10007010-010,857,2279,1083,1196,107Y09M
10007,10007010,10007010-059,431,1528,815,713,107Y09M
10007,10007060,10007060-018,397,1552,816,736,107Y09M
10007,10007060,10007060-007,443,1636,843,793,107Y09M
10007,10007060,10007060-013,326,1243,659,584,107Y09M
10007,10007060,10007060-003,389,1425,762,663,107Y09M
10007,10007060,10007060-006,394,1467,749,718,107Y09M
10007,10007060,10007060-005,392,1377,723,654,107Y09M
10007,10007060,10007060-004,472,1739,917,822,107Y09M
10007,10007060,10007060-021,750,2905,1506,1399,107Y09M
10007,10007060,10007060-022,612,2353,1191,1162,107Y09M
10007,10007060,10007060-011,763,2961,1538,1423,107Y09M
10007,10007060,10007060-002,498,1703,910,793,107Y09M
10007,10007060,10007060-016,665,2799,1449,1350,107Y09M
10007,10007060,10007060-014,713,2681,1427,1254,107Y09M
10007,10007060,10007060-001,491,1762,912,850,107Y09M
10007,10007060,10007060-009,808,2855,1520,1335,107Y09M
10007,10007060,10007060-015,591,2309,1261,1048,107Y09M
10007,10007060,10007060-008,289,957,488,469,107Y09M
10007,10007060,10007060-020,829,3049,1582,1467,107Y09M
10007,10007060,10007060-019,1330,4306,2209,2097,107Y09M
10007,10007060,10007060-017,390,1601,837,764,107Y09M
10007,10007060,10007060-010,1020,3043,1512,1531,107Y09M
10007,10007060,10007060-012,401,1460,768,692,107Y09M
10007,10007040,10007040-006,577,2235,1163,1072,107Y09M
10007,10007040,10007040-002,381,1489,770,719,107Y09M
10007,10007040,10007040-007,834,3098,1631,1467,107Y09M
10007,10007040,10007040-003,755,2782,1444,1338,107Y09M
10007,10007040,10007040-004,385,1513,761,752,107Y09M
10007,10007040,10007040-005,380,1417,704,713,107Y09M
10007,10007040,10007040-008,419,1573,812,761,107Y09M
10007,10007040,10007040-001,704,2774,1363,1411,107Y09M
66000,66000110,66000110-002,459,1288,638,650,107Y09M
66000,66000110,66000110-009,1762,5197,2503,2694,107Y09M
66000,66000110,66000110-021,407,1513,777,736,107Y09M
66000,66000110,66000110-004,371,1014,536,478,107Y09M
66000,66000110,66000110-014,357,1283,651,632,107Y09M
66000,66000110,66000110-016,2052,6772,3286,3486,107Y09M
66000,66000110,66000110-024,2012,6823,3436,3387,107Y09M
66000,66000110,66000110-005,786,2700,1326,1374,107Y09M
66000,66000110,66000110-019,469,1673,864,809,107Y09M
66000,66000110,66000110-026,541,1961,983,978,107Y09M
66000,66000110,66000110-006,770,2572,1305,1267,107Y09M
66000,66000110,66000110-017,793,2532,1241,1291,107Y09M
66000,66000110,66000110-022,1467,4988,2461,2527,107Y09M
66000,66000110,66000110-008,801,2603,1308,1295,107Y09M
66000,66000110,66000110-023,924,3126,1624,1502,107Y09M
66000,66000110,66000110-015,533,2148,1098,1050,107Y09M
66000,66000110,66000110-013,377,1407,732,675,107Y09M
66000,66000110,66000110-010,336,961,491,470,107Y09M
66000,66000110,66000110-029,465,1767,911,856,107Y09M
66000,66000110,66000110-020,1663,5624,2836,2788,107Y09M
66000,66000110,66000110-001,559,1763,850,913,107Y09M
66000,66000110,66000110-003,649,1854,939,915,107Y09M
66000,66000110,66000110-007,1307,4193,2100,2093,107Y09M
66000,66000110,66000110-012,1111,3896,1977,1919,107Y09M
66000,66000110,66000110-028,381,1334,659,675,107Y09M
66000,66000110,66000110-027,463,1693,899,794,107Y09M
66000,66000110,66000110-018,586,2106,1078,1028,107Y09M
66000,66000110,66000110-025,515,1834,972,862,107Y09M
66000,66000110,66000110-011,370,1034,515,519,107Y09M
66000,66000220,66000220-003,882,3097,1637,1460,107Y09M
66000,66000220,66000220-008,579,2075,1099,976,107Y09M
66000,66000220,66000220-011,567,2062,1072,990,107Y09M
66000,66000220,66000220-006,432,1441,750,691,107Y09M
66000,66000220,66000220-012,329,1087,572,515,107Y09M
66000,66000220,66000220-002,351,1202,641,561,107Y09M
66000,66000220,66000220-001,358,1229,651,578,107Y09M
66000,66000220,66000220-010,507,1663,865,798,107Y09M
66000,66000220,66000220-007,285,1052,533,519,107Y09M
66000,66000220,66000220-009,345,1193,639,554,107Y09M
66000,66000220,66000220-005,396,1342,731,611,107Y09M
66000,66000220,66000220-004,507,1826,970,856,107Y09M
66000,66000240,66000240-008,855,2608,1272,1336,107Y09M
66000,66000240,66000240-007,1128,3702,1904,1798,107Y09M
66000,66000240,66000240-013,520,1581,805,776,107Y09M
66000,66000240,66000240-002,272,1027,520,507,107Y09M
66000,66000240,66000240-001,1498,5214,2736,2478,107Y09M
66000,66000240,66000240-009,305,1000,514,486,107Y09M
66000,66000240,66000240-011,550,1982,1065,917,107Y09M
66000,66000240,66000240-012,316,1138,598,540,107Y09M
66000,66000240,66000240-017,1481,4101,2049,2052,107Y09M
66000,66000240,66000240-005,828,2900,1493,1407,107Y09M
66000,66000240,66000240-014,2989,9081,4535,4546,107Y09M
66000,66000240,66000240-006,973,3104,1628,1476,107Y09M
66000,66000240,66000240-015,1872,6059,3113,2946,107Y09M
66000,66000240,66000240-003,1273,4299,2183,2116,107Y09M
66000,66000240,66000240-016,1863,5787,2925,2862,107Y09M
66000,66000240,66000240-004,476,1734,899,835,107Y09M
66000,66000240,66000240-010,615,1977,1009,968,107Y09M
66000,66000280,66000280-012,1582,5202,2596,2606,107Y09M
66000,66000280,66000280-001,1297,4107,2060,2047,107Y09M
66000,66000280,66000280-022,1750,4943,2435,2508,107Y09M
66000,66000280,66000280-025,2308,6626,3168,3458,107Y09M
66000,66000280,66000280-014,3167,10501,5242,5259,107Y09M
66000,66000280,66000280-027,2241,7453,3648,3805,107Y09M
66000,66000280,66000280-008,3727,9978,4723,5255,107Y09M
66000,66000280,66000280-006,1628,4786,2383,2403,107Y09M
66000,66000280,66000280-023,4160,13039,6123,6916,107Y09M
66000,66000280,66000280-010,2172,6313,3149,3164,107Y09M
66000,66000280,66000280-026,3135,9446,4659,4787,107Y09M
66000,66000280,66000280-020,1085,3495,1744,1751,107Y09M
66000,66000280,66000280-007,2400,6771,3275,3496,107Y09M
66000,66000280,66000280-009,1336,4067,2028,2039,107Y09M
66000,66000280,66000280-019,4278,12208,5958,6250,107Y09M
66000,66000280,66000280-004,2788,8468,4090,4378,107Y09M
66000,66000280,66000280-018,3971,11848,5819,6029,107Y09M
66000,66000280,66000280-024,3656,10741,5081,5660,107Y09M
66000,66000280,66000280-013,357,1154,625,529,107Y09M
66000,66000280,66000280-015,1712,5222,2671,2551,107Y09M
66000,66000280,66000280-021,2275,7130,3476,3654,107Y09M
66000,66000280,66000280-005,3098,8165,3941,4224,107Y09M
66000,66000280,66000280-016,3152,10147,5174,4973,107Y09M
66000,66000280,66000280-011,2947,9063,4518,4545,107Y09M
66000,66000280,66000280-002,4304,12244,6194,6050,107Y09M
66000,66000280,66000280-017,4400,14270,6975,7295,107Y09M
66000,66000280,66000280-003,1242,4418,2176,2242,107Y09M
66000,66000180,66000180-010,2281,7348,3610,3738,107Y09M
66000,66000180,66000180-007,1945,6519,3254,3265,107Y09M
66000,66000180,66000180-012,2488,7253,3607,3646,107Y09M
66000,66000180,66000180-009,2233,7540,3820,3720,107Y09M
66000,66000180,66000180-001,1734,5320,2627,2693,107Y09M
66000,66000180,66000180-014,1834,5884,2871,3013,107Y09M
66000,66000180,66000180-003,2438,7558,3782,3776,107Y09M
66000,66000180,66000180-013,2378,7221,3560,3661,107Y09M
66000,66000180,66000180-011,1732,5654,2790,2864,107Y09M
66000,66000180,66000180-008,1684,5899,3021,2878,107Y09M
66000,66000180,66000180-004,1112,3897,2019,1878,107Y09M
66000,66000180,66000180-005,1644,4305,2143,2162,107Y09M
66000,66000180,66000180-002,3387,11589,5727,5862,107Y09M
66000,66000180,66000180-015,1457,4439,2163,2276,107Y09M
66000,66000180,66000180-006,1584,5191,2647,2544,107Y09M
66000,66000010,66000010-007,1260,2913,1456,1457,107Y09M
66000,66000010,66000010-002,1008,2719,1310,1409,107Y09M
66000,66000010,66000010-008,1125,2367,1176,1191,107Y09M
66000,66000010,66000010-004,770,1801,881,920,107Y09M
66000,66000010,66000010-005,1045,2545,1230,1315,107Y09M
66000,66000010,66000010-006,1061,2219,1164,1055,107Y09M
66000,66000010,66000010-003,894,2076,1038,1038,107Y09M
66000,66000010,66000010-001,821,1892,928,964,107Y09M
66000,66000270,66000270-035,975,2945,1473,1472,107Y09M
66000,66000270,66000270-008,1728,4150,2237,1913,107Y09M
66000,66000270,66000270-003,1612,5003,2507,2496,107Y09M
66000,66000270,66000270-024,1509,4444,2257,2187,107Y09M
66000,66000270,66000270-004,1265,3941,1993,1948,107Y09M
66000,66000270,66000270-001,2043,6549,3341,3208,107Y09M
66000,66000270,66000270-025,859,2727,1396,1331,107Y09M
66000,66000270,66000270-021,1653,4958,2436,2522,107Y09M
66000,66000270,66000270-020,2568,8124,4014,4110,107Y09M
66000,66000270,66000270-039,958,3076,1553,1523,107Y09M
66000,66000270,66000270-033,1615,4360,2146,2214,107Y09M
66000,66000270,66000270-010,2064,6014,2943,3071,107Y09M
66000,66000270,66000270-017,1162,3812,1958,1854,107Y09M
66000,66000270,66000270-022,1555,4730,2325,2405,107Y09M
66000,66000270,66000270-009,1266,3850,1929,1921,107Y09M
66000,66000270,66000270-031,2455,7114,3460,3654,107Y09M
66000,66000270,66000270-032,1576,4462,2258,2204,107Y09M
66000,66000270,66000270-007,2436,7309,3624,3685,107Y09M
66000,66000270,66000270-006,1646,5081,2490,2591,107Y09M
66000,66000270,66000270-015,460,1361,725,636,107Y09M
66000,66000270,66000270-023,1075,3375,1661,1714,107Y09M
66000,66000270,66000270-002,2295,7202,3502,3700,107Y09M
66000,66000270,66000270-005,1099,3418,1693,1725,107Y09M
66000,66000270,66000270-026,1242,3441,1717,1724,107Y09M
66000,66000270,66000270-019,320,754,446,308,107Y09M
66000,66000270,66000270-036,907,2569,1228,1341,107Y09M
66000,66000270,66000270-012,2903,8780,4350,4430,107Y09M
66000,66000270,66000270-029,2257,6824,3372,3452,107Y09M
66000,66000270,66000270-011,3211,8967,4388,4579,107Y09M
66000,66000270,66000270-030,2395,6570,3142,3428,107Y09M
66000,66000270,66000270-028,3429,8704,4193,4511,107Y09M
66000,66000270,66000270-013,2637,7156,3368,3788,107Y09M
66000,66000270,66000270-027,2338,6183,2951,3232,107Y09M
66000,66000270,66000270-037,600,1800,933,867,107Y09M
66000,66000270,66000270-038,1384,4277,2143,2134,107Y09M
66000,66000270,66000270-018,1862,5795,2913,2882,107Y09M
66000,66000270,66000270-016,1232,3799,1904,1895,107Y09M
66000,66000270,66000270-014,671,2118,1119,999,107Y09M
66000,66000270,66000270-034,1722,5149,2522,2627,107Y09M
66000,66000080,66000080-013,5424,12827,6096,6731,107Y09M
66000,66000080,66000080-003,3135,8345,3909,4436,107Y09M
66000,66000080,66000080-041,2499,6753,3211,3542,107Y09M
66000,66000080,66000080-014,785,2412,1231,1181,107Y09M
66000,66000080,66000080-031,2048,5748,2788,2960,107Y09M
66000,66000080,66000080-017,4357,10836,5452,5384,107Y09M
66000,66000080,66000080-018,3636,10560,5028,5532,107Y09M
66000,66000080,66000080-022,477,1205,577,628,107Y09M
66000,66000080,66000080-008,5800,16604,8128,8476,107Y09M
66000,66000080,66000080-023,2845,7656,3703,3953,107Y09M
66000,66000080,66000080-002,1517,3893,1796,2097,107Y09M
66000,66000080,66000080-034,1389,3711,1830,1881,107Y09M
66000,66000080,66000080-001,1424,3748,1810,1938,107Y09M
66000,66000080,66000080-019,602,1953,983,970,107Y09M
66000,66000080,66000080-035,2303,5728,2647,3081,107Y09M
66000,66000080,66000080-004,2500,6649,3182,3467,107Y09M
66000,66000080,66000080-026,2278,6127,3014,3113,107Y09M
66000,66000080,66000080-005,2415,6278,2865,3413,107Y09M
66000,66000080,66000080-040,2033,5196,2479,2717,107Y09M
66000,66000080,66000080-038,2138,5892,2782,3110,107Y09M
66000,66000080,66000080-027,1430,3770,1744,2026,107Y09M
66000,66000080,66000080-036,1621,4458,2091,2367,107Y09M
66000,66000080,66000080-028,2957,7586,3557,4029,107Y09M
66000,66000080,66000080-039,3058,7923,3695,4228,107Y09M
66000,66000080,66000080-012,369,1177,623,554,107Y09M
66000,66000080,66000080-015,376,1044,551,493,107Y09M
66000,66000080,66000080-021,2151,6210,3058,3152,107Y09M
66000,66000080,66000080-020,4179,11619,5536,6083,107Y09M
66000,66000080,66000080-010,4515,13014,6277,6737,107Y09M
66000,66000080,66000080-042,1639,4643,2173,2470,107Y09M
66000,66000080,66000080-011,796,2441,1226,1215,107Y09M
66000,66000080,66000080-006,2018,5293,2517,2776,107Y09M
66000,66000080,66000080-029,2087,5791,2725,3066,107Y09M
66000,66000080,66000080-016,3740,10248,4774,5474,107Y09M
66000,66000080,66000080-037,2693,7682,3718,3964,107Y09M
66000,66000080,66000080-033,2130,6113,2961,3152,107Y09M
66000,66000080,66000080-030,2209,6083,2959,3124,107Y09M
66000,66000080,66000080-032,3067,8164,3868,4296,107Y09M
66000,66000080,66000080-009,4920,14941,7220,7721,107Y09M
66000,66000080,66000080-024,1961,5424,2588,2836,107Y09M
66000,66000080,66000080-025,1866,4925,2367,2558,107Y09M
66000,66000080,66000080-007,2560,7107,3376,3731,107Y09M
66000,66000050,66000050-028,994,2484,1231,1253,107Y09M
66000,66000050,66000050-026,770,1986,961,1025,107Y09M
66000,66000050,66000050-019,1187,3105,1537,1568,107Y09M
66000,66000050,66000050-003,638,1656,827,829,107Y09M
66000,66000050,66000050-027,893,1921,952,969,107Y09M
66000,66000050,66000050-002,1637,3819,1815,2004,107Y09M
66000,66000050,66000050-034,1738,4391,2029,2362,107Y09M
66000,66000050,66000050-001,1104,2330,1117,1213,107Y09M
66000,66000050,66000050-017,1742,4281,2031,2250,107Y09M
66000,66000050,66000050-033,1274,3152,1532,1620,107Y09M
66000,66000050,66000050-022,2363,6286,2993,3293,107Y09M
66000,66000050,66000050-012,1081,2752,1297,1455,107Y09M
66000,66000050,66000050-010,1196,2902,1382,1520,107Y09M
66000,66000050,66000050-011,2127,4959,2369,2590,107Y09M
66000,66000050,66000050-023,2780,7272,3369,3903,107Y09M
66000,66000050,66000050-008,2423,6395,3122,3273,107Y09M
66000,66000050,66000050-030,1464,3899,1884,2015,107Y09M
66000,66000050,66000050-013,2620,6585,3140,3445,107Y09M
66000,66000050,66000050-021,2879,7753,3756,3997,107Y09M
66000,66000050,66000050-031,1687,4176,1968,2208,107Y09M
66000,66000050,66000050-035,1368,3720,1702,2018,107Y09M
66000,66000050,66000050-018,2428,5907,2796,3111,107Y09M
66000,66000050,66000050-014,1988,4844,2272,2572,107Y09M
66000,66000050,66000050-005,896,1916,952,964,107Y09M
66000,66000050,66000050-004,758,1707,863,844,107Y09M
66000,66000050,66000050-006,1348,2958,1438,1520,107Y09M
66000,66000050,66000050-016,2228,5213,2455,2758,107Y09M
66000,66000050,66000050-032,2028,5124,2414,2710,107Y09M
66000,66000050,66000050-024,1804,4511,2072,2439,107Y09M
66000,66000050,66000050-015,2892,6122,3088,3034,107Y09M
66000,66000050,66000050-036,1807,4705,2213,2492,107Y09M
66000,66000050,66000050-025,1770,4576,2158,2418,107Y09M
66000,66000050,66000050-029,946,2135,1021,1114,107Y09M
66000,66000050,66000050-007,1423,3683,1808,1875,107Y09M
66000,66000050,66000050-009,1526,3917,1897,2020,107Y09M
66000,66000050,66000050-020,1911,4379,2053,2326,107Y09M
66000,66000210,66000210-011,398,1392,743,649,107Y09M
66000,66000210,66000210-003,668,2229,1191,1038,107Y09M
66000,66000210,66000210-010,493,1890,997,893,107Y09M
66000,66000210,66000210-004,1699,5643,2875,2768,107Y09M
66000,66000210,66000210-006,2424,7548,3778,3770,107Y09M
66000,66000210,66000210-008,402,1448,715,733,107Y09M
66000,66000210,66000210-002,795,2675,1311,1364,107Y09M
66000,66000210,66000210-005,1314,4010,2059,1951,107Y09M
66000,66000210,66000210-001,375,1246,646,600,107Y09M
66000,66000210,66000210-007,484,1639,859,780,107Y09M
66000,66000210,66000210-009,766,2477,1281,1196,107Y09M
66000,66000200,66000200-003,477,1416,762,654,107Y09M
66000,66000200,66000200-008,381,1157,591,566,107Y09M
66000,66000200,66000200-001,475,1509,771,738,107Y09M
66000,66000200,66000200-010,535,1381,707,674,107Y09M
66000,66000200,66000200-004,439,1457,757,700,107Y09M
66000,66000200,66000200-007,699,2130,1106,1024,107Y09M
66000,66000200,66000200-002,589,1795,931,864,107Y09M
66000,66000200,66000200-006,530,1699,862,837,107Y09M
66000,66000200,66000200-009,566,1672,849,823,107Y09M
66000,66000200,66000200-005,222,757,408,349,107Y09M
66000,66000150,66000150-010,860,2988,1509,1479,107Y09M
66000,66000150,66000150-002,384,1305,671,634,107Y09M
66000,66000150,66000150-016,681,2546,1314,1232,107Y09M
66000,66000150,66000150-013,711,2602,1319,1283,107Y09M
66000,66000150,66000150-017,667,2315,1209,1106,107Y09M
66000,66000150,66000150-004,1342,4459,2260,2199,107Y09M
66000,66000150,66000150-005,773,2569,1306,1263,107Y09M
66000,66000150,66000150-014,1128,3855,1958,1897,107Y09M
66000,66000150,66000150-015,492,1560,816,744,107Y09M
66000,66000150,66000150-003,1240,3775,1894,1881,107Y09M
66000,66000150,66000150-018,993,3186,1558,1628,107Y09M
66000,66000150,66000150-009,1257,4265,2125,2140,107Y09M
66000,66000150,66000150-007,815,2385,1241,1144,107Y09M
66000,66000150,66000150-006,1767,5872,2965,2907,107Y09M
66000,66000150,66000150-008,1204,4061,2078,1983,107Y09M
66000,66000150,66000150-001,866,2371,1183,1188,107Y09M
66000,66000150,66000150-012,524,1896,981,915,107Y09M
66000,66000150,66000150-011,736,2664,1339,1325,107Y09M
66000,66000060,66000060-006,2568,6231,2917,3314,107Y09M
66000,66000060,66000060-027,2573,6372,3006,3366,107Y09M
66000,66000060,66000060-028,1864,4979,2344,2635,107Y09M
66000,66000060,66000060-012,1058,2446,1165,1281,107Y09M
66000,66000060,66000060-011,1481,4549,2222,2327,107Y09M
66000,66000060,66000060-013,1409,3726,1816,1910,107Y09M
66000,66000060,66000060-014,2156,5633,2672,2961,107Y09M
66000,66000060,66000060-018,6187,16009,7771,8238,107Y09M
66000,66000060,66000060-026,2076,5279,2487,2792,107Y09M
66000,66000060,66000060-024,2388,6095,2940,3155,107Y09M
66000,66000060,66000060-001,2192,5954,2862,3092,107Y09M
66000,66000060,66000060-002,2577,6808,3345,3463,107Y09M
66000,66000060,66000060-021,2735,7394,3571,3823,107Y09M
66000,66000060,66000060-009,2360,6057,2871,3186,107Y09M
66000,66000060,66000060-031,3348,8608,4007,4601,107Y09M
66000,66000060,66000060-030,1565,4208,1999,2209,107Y09M
66000,66000060,66000060-025,1922,4952,2308,2644,107Y09M
66000,66000060,66000060-010,1492,3837,1792,2045,107Y09M
66000,66000060,66000060-023,2776,7779,3683,4096,107Y09M
66000,66000060,66000060-032,1904,5145,2469,2676,107Y09M
66000,66000060,66000060-022,1619,4353,2063,2290,107Y09M
66000,66000060,66000060-020,1996,5553,2785,2768,107Y09M
66000,66000060,66000060-017,1307,4261,2115,2146,107Y09M
66000,66000060,66000060-007,2155,5242,2450,2792,107Y09M
66000,66000060,66000060-029,2437,6581,3190,3391,107Y09M
66000,66000060,66000060-005,7273,17753,8336,9417,107Y09M
66000,66000060,66000060-015,2063,6112,2991,3121,107Y09M
66000,66000060,66000060-034,1347,3832,1847,1985,107Y09M
66000,66000060,66000060-019,1252,3410,1628,1782,107Y09M
66000,66000060,66000060-033,1699,5146,2554,2592,107Y09M
66000,66000060,66000060-038,3474,9214,4307,4907,107Y09M
66000,66000060,66000060-035,2262,5704,2737,2967,107Y09M
66000,66000060,66000060-039,2773,7420,3532,3888,107Y09M
66000,66000060,66000060-037,1456,3859,1835,2024,107Y09M
66000,66000060,66000060-036,1593,3910,1859,2051,107Y09M
66000,66000060,66000060-016,780,2939,1462,1477,107Y09M
66000,66000060,66000060-003,3032,6455,3354,3101,107Y09M
66000,66000060,66000060-004,291,983,514,469,107Y09M
66000,66000060,66000060-008,1327,3194,1559,1635,107Y09M
66000,66000040,66000040-003,1376,3154,1623,1531,107Y09M
66000,66000040,66000040-018,2605,6587,3184,3403,107Y09M
66000,66000040,66000040-025,2082,5245,2423,2822,107Y09M
66000,66000040,66000040-021,1640,4227,2012,2215,107Y09M
66000,66000040,66000040-022,2345,5797,2660,3137,107Y09M
66000,66000040,66000040-017,2816,7554,3514,4040,107Y09M
66000,66000040,66000040-007,2253,5550,2640,2910,107Y09M
66000,66000040,66000040-020,1239,3291,1558,1733,107Y09M
66000,66000040,66000040-023,2002,5107,2374,2733,107Y09M
66000,66000040,66000040-009,2723,6744,3193,3551,107Y09M
66000,66000040,66000040-006,1011,2558,1187,1371,107Y09M
66000,66000040,66000040-001,1012,2651,1229,1422,107Y09M
66000,66000040,66000040-011,1597,3828,1853,1975,107Y09M
66000,66000040,66000040-014,2986,7717,3612,4105,107Y09M
66000,66000040,66000040-013,1443,3298,1623,1675,107Y09M
66000,66000040,66000040-002,742,2110,1016,1094,107Y09M
66000,66000040,66000040-010,1112,2704,1352,1352,107Y09M
66000,66000040,66000040-016,2802,6745,3201,3544,107Y09M
66000,66000040,66000040-019,2588,6669,3196,3473,107Y09M
66000,66000040,66000040-015,2665,6644,3111,3533,107Y09M
66000,66000040,66000040-004,1074,2889,1378,1511,107Y09M
66000,66000040,66000040-012,1802,4296,2034,2262,107Y09M
66000,66000040,66000040-005,708,1859,884,975,107Y09M
66000,66000040,66000040-008,1888,5041,2383,2658,107Y09M
66000,66000040,66000040-024,1292,3241,1553,1688,107Y09M
66000,66000130,66000130-021,3167,8626,4278,4348,107Y09M
66000,66000130,66000130-014,2077,6266,3205,3061,107Y09M
66000,66000130,66000130-017,1768,5215,2615,2600,107Y09M
66000,66000130,66000130-006,1597,5375,2725,2650,107Y09M
66000,66000130,66000130-011,1976,6220,3153,3067,107Y09M
66000,66000130,66000130-009,2811,9362,4652,4710,107Y09M
66000,66000130,66000130-019,877,2517,1278,1239,107Y09M
66000,66000130,66000130-003,358,1232,613,619,107Y09M
66000,66000130,66000130-001,554,1694,873,821,107Y09M
66000,66000130,66000130-015,1316,4202,2160,2042,107Y09M
66000,66000130,66000130-002,773,2627,1303,1324,107Y09M
66000,66000130,66000130-004,202,647,326,321,107Y09M
66000,66000130,66000130-016,2319,6700,3400,3300,107Y09M
66000,66000130,66000130-013,666,1996,1031,965,107Y09M
66000,66000130,66000130-018,914,2767,1411,1356,107Y09M
66000,66000130,66000130-010,423,1411,746,665,107Y09M
66000,66000130,66000130-007,1959,6283,3170,3113,107Y09M
66000,66000130,66000130-008,2554,8531,4246,4285,107Y09M
66000,66000130,66000130-012,1434,4506,2307,2199,107Y09M
66000,66000130,66000130-005,982,3190,1578,1612,107Y09M
66000,66000130,66000130-020,1312,4239,2136,2103,107Y09M
66000,66000290,66000290-004,241,509,284,225,107Y09M
66000,66000290,66000290-002,241,490,262,228,107Y09M
66000,66000290,66000290-008,377,1033,583,450,107Y09M
66000,66000290,66000290-005,486,1256,687,569,107Y09M
66000,66000290,66000290-001,923,2168,1154,1014,107Y09M
66000,66000290,66000290-007,1041,2326,1236,1090,107Y09M
66000,66000290,66000290-003,810,1950,989,961,107Y09M
66000,66000290,66000290-006,496,1347,732,615,107Y09M
66000,66000020,66000020-010,1997,5577,2758,2819,107Y09M
66000,66000020,66000020-005,1026,2244,1086,1158,107Y09M
66000,66000020,66000020-013,1854,4894,2440,2454,107Y09M
66000,66000020,66000020-007,992,2873,1496,1377,107Y09M
66000,66000020,66000020-009,2536,7869,3901,3968,107Y09M
66000,66000020,66000020-016,3662,10653,5187,5466,107Y09M
66000,66000020,66000020-011,1632,4397,2142,2255,107Y09M
66000,66000020,66000020-017,2900,8206,4061,4145,107Y09M
66000,66000020,66000020-012,1204,3076,1600,1476,107Y09M
66000,66000020,66000020-003,1482,4281,2069,2212,107Y09M
66000,66000020,66000020-004,1227,3308,1629,1679,107Y09M
66000,66000020,66000020-006,933,2223,1131,1092,107Y09M
66000,66000020,66000020-002,1423,3644,1837,1807,107Y09M
66000,66000020,66000020-015,1974,4694,2325,2369,107Y09M
66000,66000020,66000020-014,883,1914,969,945,107Y09M
66000,66000020,66000020-001,1616,3640,1895,1745,107Y09M
66000,66000020,66000020-008,907,2588,1303,1285,107Y09M
66000,66000100,66000100-015,351,964,496,468,107Y09M
66000,66000100,66000100-020,642,1889,978,911,107Y09M
66000,66000100,66000100-014,388,1121,579,542,107Y09M
66000,66000100,66000100-006,399,1150,576,574,107Y09M
66000,66000100,66000100-009,758,2178,1112,1066,107Y09M
66000,66000100,66000100-002,396,1035,496,539,107Y09M
66000,66000100,66000100-001,615,1601,818,783,107Y09M
66000,66000100,66000100-005,943,2605,1284,1321,107Y09M
66000,66000100,66000100-025,501,1577,854,723,107Y09M
66000,66000100,66000100-003,461,1237,621,616,107Y09M
66000,66000100,66000100-018,829,2216,1151,1065,107Y09M
66000,66000100,66000100-004,758,2210,1105,1105,107Y09M
66000,66000100,66000100-022,725,2101,1126,975,107Y09M
66000,66000100,66000100-008,1455,4177,2114,2063,107Y09M
66000,66000100,66000100-023,268,819,445,374,107Y09M
66000,66000100,66000100-024,258,737,388,349,107Y09M
66000,66000100,66000100-011,584,1680,878,802,107Y09M
66000,66000100,66000100-013,622,1904,968,936,107Y09M
66000,66000100,66000100-012,1922,5846,2972,2874,107Y09M
66000,66000100,66000100-019,828,2345,1178,1167,107Y09M
66000,66000100,66000100-010,1434,4304,2154,2150,107Y09M
66000,66000100,66000100-007,605,1706,885,821,107Y09M
66000,66000100,66000100-016,706,2130,1126,1004,107Y09M
66000,66000100,66000100-017,508,1466,776,690,107Y09M
66000,66000100,66000100-021,452,1371,745,626,107Y09M
66000,66000070,66000070-024,3952,10614,4916,5698,107Y09M
66000,66000070,66000070-010,3096,8753,4056,4697,107Y09M
66000,66000070,66000070-025,3075,8305,3845,4460,107Y09M
66000,66000070,66000070-015,2083,5759,2728,3031,107Y09M
66000,66000070,66000070-021,2936,7965,3664,4301,107Y09M
66000,66000070,66000070-019,1721,4260,1967,2293,107Y09M
66000,66000070,66000070-020,1867,5334,2509,2825,107Y09M
66000,66000070,66000070-004,1692,5254,2632,2622,107Y09M
66000,66000070,66000070-007,4801,12399,5968,6431,107Y09M
66000,66000070,66000070-016,1753,4663,2223,2440,107Y09M
66000,66000070,66000070-009,2107,5962,2917,3045,107Y09M
66000,66000070,66000070-012,2740,7557,3641,3916,107Y09M
66000,66000070,66000070-017,2446,6342,2950,3392,107Y09M
66000,66000070,66000070-018,2620,6308,3194,3114,107Y09M
66000,66000070,66000070-001,3902,10890,5096,5794,107Y09M
66000,66000070,66000070-006,393,959,476,483,107Y09M
66000,66000070,66000070-005,3182,7539,3858,3681,107Y09M
66000,66000070,66000070-022,3445,9275,4280,4995,107Y09M
66000,66000070,66000070-008,699,1651,830,821,107Y09M
66000,66000070,66000070-003,2446,7133,3553,3580,107Y09M
66000,66000070,66000070-011,2392,6594,3043,3551,107Y09M
66000,66000070,66000070-013,1839,5042,2475,2567,107Y09M
66000,66000070,66000070-002,4813,13342,6444,6898,107Y09M
66000,66000070,66000070-014,546,1666,894,772,107Y09M
66000,66000070,66000070-023,2527,6442,3115,3327,107Y09M
66000,66000030,66000030-021,3086,8154,3858,4296,107Y09M
66000,66000030,66000030-018,1474,4080,2030,2050,107Y09M
66000,66000030,66000030-020,2116,5276,2537,2739,107Y09M
66000,66000030,66000030-011,3637,9511,4534,4977,107Y09M
66000,66000030,66000030-006,1293,3180,1544,1636,107Y09M
66000,66000030,66000030-014,1885,5176,2450,2726,107Y09M
66000,66000030,66000030-010,1893,4658,2190,2468,107Y09M
66000,66000030,66000030-015,907,2304,1130,1174,107Y09M
66000,66000030,66000030-016,1139,3024,1495,1529,107Y09M
66000,66000030,66000030-019,3647,8533,4174,4359,107Y09M
66000,66000030,66000030-003,1694,4000,1931,2069,107Y09M
66000,66000030,66000030-001,1688,4165,2022,2143,107Y09M
66000,66000030,66000030-002,1804,4426,2151,2275,107Y09M
66000,66000030,66000030-022,2534,6686,3231,3455,107Y09M
66000,66000030,66000030-007,2260,5445,2528,2917,107Y09M
66000,66000030,66000030-009,2328,6322,3032,3290,107Y09M
66000,66000030,66000030-017,2591,6472,3100,3372,107Y09M
66000,66000030,66000030-008,1693,4494,2172,2322,107Y09M
66000,66000030,66000030-004,1364,3256,1555,1701,107Y09M
66000,66000030,66000030-012,4896,13830,6558,7272,107Y09M
66000,66000030,66000030-013,3869,9743,4648,5095,107Y09M
66000,66000030,66000030-005,1113,2942,1462,1480,107Y09M
66000,66000230,66000230-006,5190,16240,7983,8257,107Y09M
66000,66000230,66000230-003,2198,5680,2904,2776,107Y09M
66000,66000230,66000230-009,596,1903,988,915,107Y09M
66000,66000230,66000230-007,3145,9506,4557,4949,107Y09M
66000,66000230,66000230-014,557,1925,996,929,107Y09M
66000,66000230,66000230-010,776,2549,1304,1245,107Y09M
66000,66000230,66000230-011,744,2573,1350,1223,107Y09M
66000,66000230,66000230-008,807,2754,1417,1337,107Y09M
66000,66000230,66000230-015,444,1553,810,743,107Y09M
66000,66000230,66000230-001,3586,10068,5008,5060,107Y09M
66000,66000230,66000230-002,1048,2980,1522,1458,107Y09M
66000,66000230,66000230-016,311,993,526,467,107Y09M
66000,66000230,66000230-012,1480,5210,2634,2576,107Y09M
66000,66000230,66000230-004,2403,5920,2941,2979,107Y09M
66000,66000230,66000230-005,984,2866,1473,1393,107Y09M
66000,66000230,66000230-013,776,2481,1256,1225,107Y09M
66000,66000160,66000160-007,913,3070,1580,1490,107Y09M
66000,66000160,66000160-009,1816,5127,2494,2633,107Y09M
66000,66000160,66000160-016,354,1224,632,592,107Y09M
66000,66000160,66000160-003,938,3081,1593,1488,107Y09M
66000,66000160,66000160-013,851,2826,1425,1401,107Y09M
66000,66000160,66000160-015,787,2480,1273,1207,107Y09M
66000,66000160,66000160-002,784,2555,1290,1265,107Y09M
66000,66000160,66000160-004,708,2647,1364,1283,107Y09M
66000,66000160,66000160-008,1017,3367,1705,1662,107Y09M
66000,66000160,66000160-005,2616,8933,4566,4367,107Y09M
66000,66000160,66000160-006,1807,6500,3296,3204,107Y09M
66000,66000160,66000160-001,1225,3920,2028,1892,107Y09M
66000,66000160,66000160-011,842,3090,1565,1525,107Y09M
66000,66000160,66000160-014,1439,5008,2596,2412,107Y09M
66000,66000160,66000160-012,920,3341,1725,1616,107Y09M
66000,66000160,66000160-010,2597,8454,4305,4149,107Y09M
66000,66000140,66000140-002,772,2343,1197,1146,107Y09M
66000,66000140,66000140-010,2790,9438,4698,4740,107Y09M
66000,66000140,66000140-011,2096,7217,3579,3638,107Y09M
66000,66000140,66000140-003,1601,4748,2339,2409,107Y09M
66000,66000140,66000140-004,214,645,332,313,107Y09M
66000,66000140,66000140-005,484,1384,700,684,107Y09M
66000,66000140,66000140-014,804,3044,1575,1469,107Y09M
66000,66000140,66000140-013,733,2722,1382,1340,107Y09M
66000,66000140,66000140-006,341,1035,534,501,107Y09M
66000,66000140,66000140-008,1930,6119,3050,3069,107Y09M
66000,66000140,66000140-007,2389,7473,3806,3667,107Y09M
66000,66000140,66000140-001,1359,3781,1804,1977,107Y09M
66000,66000140,66000140-009,1675,5461,2726,2735,107Y09M
66000,66000140,66000140-012,807,2780,1439,1341,107Y09M
66000,66000120,66000120-028,977,3407,1731,1676,107Y09M
66000,66000120,66000120-017,1267,3348,1633,1715,107Y09M
66000,66000120,66000120-008,183,510,265,245,107Y09M
66000,66000120,66000120-004,298,868,441,427,107Y09M
66000,66000120,66000120-007,330,824,427,397,107Y09M
66000,66000120,66000120-026,857,2939,1503,1436,107Y09M
66000,66000120,66000120-009,880,2777,1417,1360,107Y09M
66000,66000120,66000120-006,577,1911,953,958,107Y09M
66000,66000120,66000120-032,572,1760,902,858,107Y09M
66000,66000120,66000120-013,1629,5067,2595,2472,107Y09M
66000,66000120,66000120-029,446,1424,739,685,107Y09M
66000,66000120,66000120-014,1247,3891,2011,1880,107Y09M
66000,66000120,66000120-010,3846,11933,5995,5938,107Y09M
66000,66000120,66000120-005,764,2271,1141,1130,107Y09M
66000,66000120,66000120-031,536,1614,846,768,107Y09M
66000,66000120,66000120-015,777,2387,1226,1161,107Y09M
66000,66000120,66000120-021,394,1415,742,673,107Y09M
66000,66000120,66000120-018,467,1519,827,692,107Y09M
66000,66000120,66000120-020,482,1444,780,664,107Y09M
66000,66000120,66000120-019,462,1571,868,703,107Y09M
66000,66000120,66000120-022,463,1557,828,729,107Y09M
66000,66000120,66000120-023,739,2513,1296,1217,107Y09M
66000,66000120,66000120-003,858,2618,1293,1325,107Y09M
66000,66000120,66000120-025,609,2059,1116,943,107Y09M
66000,66000120,66000120-024,737,2684,1394,1290,107Y09M
66000,66000120,66000120-030,425,1396,758,638,107Y09M
66000,66000120,66000120-011,499,1750,880,870,107Y09M
66000,66000120,66000120-027,2762,8945,4522,4423,107Y09M
66000,66000120,66000120-012,552,1776,957,819,107Y09M
66000,66000120,66000120-001,455,1267,642,625,107Y09M
66000,66000120,66000120-002,396,1151,584,567,107Y09M
66000,66000120,66000120-016,2156,6013,3116,2897,107Y09M
66000,66000190,66000190-006,687,2172,1121,1051,107Y09M
66000,66000190,66000190-003,508,1642,857,785,107Y09M
66000,66000190,66000190-012,221,664,346,318,107Y09M
66000,66000190,66000190-008,295,650,295,355,107Y09M
66000,66000190,66000190-004,372,1211,647,564,107Y09M
66000,66000190,66000190-007,983,3456,1784,1672,107Y09M
66000,66000190,66000190-009,1036,3462,1786,1676,107Y09M
66000,66000190,66000190-010,428,1442,765,677,107Y09M
66000,66000190,66000190-005,362,1366,716,650,107Y09M
66000,66000190,66000190-002,694,2270,1204,1066,107Y09M
66000,66000190,66000190-001,1232,3949,1999,1950,107Y09M
66000,66000190,66000190-013,484,1317,712,605,107Y09M
66000,66000190,66000190-011,302,998,537,461,107Y09M
66000,66000170,66000170-008,1038,3335,1726,1609,107Y09M
66000,66000170,66000170-009,2323,7183,3586,3597,107Y09M
66000,66000170,66000170-006,3893,11389,5526,5863,107Y09M
66000,66000170,66000170-007,4541,14272,7156,7116,107Y09M
66000,66000170,66000170-016,1894,5649,2717,2932,107Y09M
66000,66000170,66000170-015,3181,8560,4066,4494,107Y09M
66000,66000170,66000170-010,1756,5329,2689,2640,107Y09M
66000,66000170,66000170-012,596,1750,880,870,107Y09M
66000,66000170,66000170-011,1388,4681,2389,2292,107Y09M
66000,66000170,66000170-004,4206,12137,5964,6173,107Y09M
66000,66000170,66000170-013,1800,4844,2568,2276,107Y09M
66000,66000170,66000170-003,924,2788,1367,1421,107Y09M
66000,66000170,66000170-002,501,1582,813,769,107Y09M
66000,66000170,66000170-001,4491,13393,6471,6922,107Y09M
66000,66000170,66000170-005,2239,6579,3204,3375,107Y09M
66000,66000170,66000170-014,1868,5266,2585,2681,107Y09M
66000,66000250,66000250-008,946,3506,1808,1698,107Y09M
66000,66000250,66000250-010,2117,7084,3588,3496,107Y09M
66000,66000250,66000250-004,1105,4141,2116,2025,107Y09M
66000,66000250,66000250-001,1043,3679,1868,1811,107Y09M
66000,66000250,66000250-009,1625,6083,3092,2991,107Y09M
66000,66000250,66000250-016,3640,10427,5015,5412,107Y09M
66000,66000250,66000250-014,501,1942,978,964,107Y09M
66000,66000250,66000250-013,2164,7578,3766,3812,107Y09M
66000,66000250,66000250-015,2045,5651,2838,2813,107Y09M
66000,66000250,66000250-005,328,1208,608,600,107Y09M
66000,66000250,66000250-003,666,2267,1112,1155,107Y09M
66000,66000250,66000250-002,932,3366,1769,1597,107Y09M
66000,66000250,66000250-011,2873,8929,4483,4446,107Y09M
66000,66000250,66000250-007,1605,6168,3132,3036,107Y09M
66000,66000250,66000250-012,939,3167,1563,1604,107Y09M
66000,66000250,66000250-006,830,2698,1443,1255,107Y09M
66000,66000090,66000090-020,2336,7609,3769,3840,107Y09M
66000,66000090,66000090-005,326,883,438,445,107Y09M
66000,66000090,66000090-013,1039,2948,1459,1489,107Y09M
66000,66000090,66000090-003,364,1009,475,534,107Y09M
66000,66000090,66000090-028,2109,6872,3293,3579,107Y09M
66000,66000090,66000090-021,1227,3498,1700,1798,107Y09M
66000,66000090,66000090-027,5096,16150,7889,8261,107Y09M
66000,66000090,66000090-014,1160,3417,1701,1716,107Y09M
66000,66000090,66000090-012,535,1435,698,737,107Y09M
66000,66000090,66000090-022,2843,7458,3769,3689,107Y09M
66000,66000090,66000090-017,506,1458,738,720,107Y09M
66000,66000090,66000090-036,1158,3966,2052,1914,107Y09M
66000,66000090,66000090-009,2017,6227,2978,3249,107Y09M
66000,66000090,66000090-016,3215,11019,5526,5493,107Y09M
66000,66000090,66000090-010,919,2703,1332,1371,107Y09M
66000,66000090,66000090-029,531,1876,964,912,107Y09M
66000,66000090,66000090-015,1374,4939,2561,2378,107Y09M
66000,66000090,66000090-011,617,1801,862,939,107Y09M
66000,66000090,66000090-019,4105,11866,5759,6107,107Y09M
66000,66000090,66000090-031,1178,3779,1955,1824,107Y09M
66000,66000090,66000090-030,2124,6376,3055,3321,107Y09M
66000,66000090,66000090-025,4380,13534,6534,7000,107Y09M
66000,66000090,66000090-032,1197,3951,1985,1966,107Y09M
66000,66000090,66000090-034,1062,3403,1764,1639,107Y09M
66000,66000090,66000090-033,885,2524,1242,1282,107Y09M
66000,66000090,66000090-035,747,2457,1253,1204,107Y09M
66000,66000090,66000090-002,459,1037,497,540,107Y09M
66000,66000090,66000090-006,284,883,424,459,107Y09M
66000,66000090,66000090-026,1110,3496,1656,1840,107Y09M
66000,66000090,66000090-007,272,773,387,386,107Y09M
66000,66000090,66000090-023,3797,12278,6109,6169,107Y09M
66000,66000090,66000090-018,1358,3894,1963,1931,107Y09M
66000,66000090,66000090-008,688,1845,875,970,107Y09M
66000,66000090,66000090-001,998,2651,1288,1363,107Y09M
66000,66000090,66000090-004,532,1297,591,706,107Y09M
66000,66000090,66000090-024,1679,5610,2874,2736,107Y09M
66000,66000260,66000260-018,723,2744,1438,1306,107Y09M
66000,66000260,66000260-005,828,2332,1126,1206,107Y09M
66000,66000260,66000260-013,824,3001,1563,1438,107Y09M
66000,66000260,66000260-017,793,2898,1491,1407,107Y09M
66000,66000260,66000260-010,1414,4694,2360,2334,107Y09M
66000,66000260,66000260-019,701,2610,1298,1312,107Y09M
66000,66000260,66000260-012,842,2805,1456,1349,107Y09M
66000,66000260,66000260-008,2417,6996,3379,3617,107Y09M
66000,66000260,66000260-004,959,2695,1356,1339,107Y09M
66000,66000260,66000260-003,1869,5521,2771,2750,107Y09M
66000,66000260,66000260-002,3453,10824,5476,5348,107Y09M
66000,66000260,66000260-009,1170,3509,1762,1747,107Y09M
66000,66000260,66000260-011,630,2276,1137,1139,107Y09M
66000,66000260,66000260-020,397,1567,814,753,107Y09M
66000,66000260,66000260-016,381,1331,712,619,107Y09M
66000,66000260,66000260-001,444,1413,740,673,107Y09M
66000,66000260,66000260-007,400,1270,648,622,107Y09M
66000,66000260,66000260-014,974,3185,1635,1550,107Y09M
66000,66000260,66000260-006,478,1411,737,674,107Y09M
66000,66000260,66000260-015,716,2500,1300,1200,107Y09M
63000,63000110,63000110-033,2195,6049,2835,3214,107Y09M
63000,63000110,63000110-001,1560,4091,1969,2122,107Y09M
63000,63000110,63000110-044,546,1432,745,687,107Y09M
63000,63000110,63000110-040,2706,7245,3388,3857,107Y09M
63000,63000110,63000110-042,2597,7055,3316,3739,107Y09M
63000,63000110,63000110-041,3535,9404,4336,5068,107Y09M
63000,63000110,63000110-039,2791,7991,3811,4180,107Y09M
63000,63000110,63000110-037,1998,5486,2551,2935,107Y09M
63000,63000110,63000110-038,2005,5340,2454,2886,107Y09M
63000,63000110,63000110-036,2377,6681,3121,3560,107Y09M
63000,63000110,63000110-048,538,1536,780,756,107Y09M
63000,63000110,63000110-022,2754,7437,3719,3718,107Y09M
63000,63000110,63000110-043,454,1296,636,660,107Y09M
63000,63000110,63000110-026,2701,7426,3429,3997,107Y09M
63000,63000110,63000110-011,2556,7482,3643,3839,107Y09M
63000,63000110,63000110-025,1264,3503,1660,1843,107Y09M
63000,63000110,63000110-030,2216,5792,2755,3037,107Y09M
63000,63000110,63000110-012,2360,5769,2702,3067,107Y09M
63000,63000110,63000110-014,1989,5153,2465,2688,107Y09M
63000,63000110,63000110-032,1837,5356,2582,2774,107Y09M
63000,63000110,63000110-019,2495,6829,3346,3483,107Y09M
63000,63000110,63000110-021,2660,7698,3851,3847,107Y09M
63000,63000110,63000110-020,3501,9625,4811,4814,107Y09M
63000,63000110,63000110-031,2779,7876,3755,4121,107Y09M
63000,63000110,63000110-010,1757,4794,2283,2511,107Y09M
63000,63000110,63000110-008,3110,8571,4255,4316,107Y09M
63000,63000110,63000110-016,2185,6163,3010,3153,107Y09M
63000,63000110,63000110-024,2427,6058,3176,2882,107Y09M
63000,63000110,63000110-047,587,1662,897,765,107Y09M
63000,63000110,63000110-046,1425,3116,1495,1621,107Y09M
63000,63000110,63000110-045,748,1971,982,989,107Y09M
63000,63000110,63000110-049,575,1571,807,764,107Y09M
63000,63000110,63000110-002,1399,3405,1640,1765,107Y09M
63000,63000110,63000110-029,1965,5290,2481,2809,107Y09M
63000,63000110,63000110-018,1604,4287,2076,2211,107Y09M
63000,63000110,63000110-017,2863,8043,3886,4157,107Y09M
63000,63000110,63000110-009,2624,7298,3543,3755,107Y09M
63000,63000110,63000110-023,1862,4997,2646,2351,107Y09M
63000,63000110,63000110-005,3067,7873,3736,4137,107Y09M
63000,63000110,63000110-007,3004,8148,3910,4238,107Y09M
63000,63000110,63000110-003,1265,3124,1510,1614,107Y09M
63000,63000110,63000110-013,2602,6640,3201,3439,107Y09M
63000,63000110,63000110-015,2154,5593,2760,2833,107Y09M
63000,63000110,63000110-004,2965,6047,3167,2880,107Y09M
63000,63000110,63000110-050,1201,2747,1287,1460,107Y09M
63000,63000110,63000110-027,1938,4580,2144,2436,107Y09M
63000,63000110,63000110-028,2273,5854,2726,3128,107Y09M
63000,63000110,63000110-051,1212,3051,1479,1572,107Y09M
63000,63000110,63000110-006,2538,6467,3036,3431,107Y09M
63000,63000110,63000110-034,3341,9074,4279,4795,107Y09M
63000,63000110,63000110-035,2483,6749,3145,3604,107Y09M
63000,63000060,63000060-009,1930,5069,2479,2590,107Y09M
63000,63000060,63000060-013,2600,6824,3274,3550,107Y09M
63000,63000060,63000060-005,2269,5547,2766,2781,107Y09M
63000,63000060,63000060-001,1264,3065,1512,1553,107Y09M
63000,63000060,63000060-008,2036,5354,2587,2767,107Y09M
63000,63000060,63000060-024,2347,6094,3022,3072,107Y09M
63000,63000060,63000060-022,3402,8289,3981,4308,107Y09M
63000,63000060,63000060-010,1869,4320,2066,2254,107Y09M
63000,63000060,63000060-026,1669,4220,2056,2164,107Y09M
63000,63000060,63000060-012,1695,4296,2004,2292,107Y09M
63000,63000060,63000060-003,2068,4889,2337,2552,107Y09M
63000,63000060,63000060-002,1526,3446,1655,1791,107Y09M
63000,63000060,63000060-004,1644,3938,1894,2044,107Y09M
63000,63000060,63000060-007,2635,6420,3042,3378,107Y09M
63000,63000060,63000060-025,2540,6775,3234,3541,107Y09M
63000,63000060,63000060-017,1100,2828,1483,1345,107Y09M
63000,63000060,63000060-018,1856,4557,2156,2401,107Y09M
63000,63000060,63000060-019,2322,4512,2421,2091,107Y09M
63000,63000060,63000060-020,2197,5194,2567,2627,107Y09M
63000,63000060,63000060-014,1164,2799,1392,1407,107Y09M
63000,63000060,63000060-006,2014,4570,2185,2385,107Y09M
63000,63000060,63000060-015,1234,3261,1587,1674,107Y09M
63000,63000060,63000060-016,2092,5103,2489,2614,107Y09M
63000,63000060,63000060-021,2643,6658,3337,3321,107Y09M
63000,63000060,63000060-011,3774,9898,4812,5086,107Y09M
63000,63000030,63000030-043,3555,8816,4100,4716,107Y09M
63000,63000030,63000030-002,2041,5812,2726,3086,107Y09M
63000,63000030,63000030-005,2200,5423,2413,3010,107Y09M
63000,63000030,63000030-013,1792,4295,2024,2271,107Y09M
63000,63000030,63000030-014,3173,7459,3416,4043,107Y09M
63000,63000030,63000030-052,1972,5012,2331,2681,107Y09M
63000,63000030,63000030-004,3275,8404,3911,4493,107Y09M
63000,63000030,63000030-007,2890,6977,3299,3678,107Y09M
63000,63000030,63000030-018,1512,4051,1928,2123,107Y09M
63000,63000030,63000030-019,1438,3950,1912,2038,107Y09M
63000,63000030,63000030-010,3294,7750,3519,4231,107Y09M
63000,63000030,63000030-056,3087,8064,3730,4334,107Y09M
63000,63000030,63000030-035,1837,4486,2063,2423,107Y09M
63000,63000030,63000030-029,2320,5334,2507,2827,107Y09M
63000,63000030,63000030-055,2503,6537,2975,3562,107Y09M
63000,63000030,63000030-003,2549,7427,3635,3792,107Y09M
63000,63000030,63000030-008,1256,3147,1484,1663,107Y09M
63000,63000030,63000030-034,1889,4612,2149,2463,107Y09M
63000,63000030,63000030-039,869,2316,1056,1260,107Y09M
63000,63000030,63000030-044,2349,5884,2838,3046,107Y09M
63000,63000030,63000030-038,1736,3946,1817,2129,107Y09M
63000,63000030,63000030-049,2132,5160,2276,2884,107Y09M
63000,63000030,63000030-050,2460,6434,2868,3566,107Y09M
63000,63000030,63000030-031,2644,6336,3013,3323,107Y09M
63000,63000030,63000030-032,2334,5667,2701,2966,107Y09M
63000,63000030,63000030-051,2518,6662,3022,3640,107Y09M
63000,63000030,63000030-053,2418,6617,3046,3571,107Y09M
63000,63000030,63000030-054,1760,4371,2030,2341,107Y09M
63000,63000030,63000030-023,2639,7161,3340,3821,107Y09M
63000,63000030,63000030-030,2208,5467,2482,2985,107Y09M
63000,63000030,63000030-006,2451,5712,2694,3018,107Y09M
63000,63000030,63000030-037,2976,7032,3254,3778,107Y09M
63000,63000030,63000030-036,2479,5992,2712,3280,107Y09M
63000,63000030,63000030-009,1816,4155,1870,2285,107Y09M
63000,63000030,63000030-017,2418,6864,3124,3740,107Y09M
63000,63000030,63000030-001,2355,5911,2726,3185,107Y09M
63000,63000030,63000030-046,2086,5716,2727,2989,107Y09M
63000,63000030,63000030-047,3076,7818,3730,4088,107Y09M
63000,63000030,63000030-048,2054,4949,2335,2614,107Y09M
63000,63000030,63000030-057,1071,2760,1377,1383,107Y09M
63000,63000030,63000030-016,2385,6447,2988,3459,107Y09M
63000,63000030,63000030-020,1401,3924,1889,2035,107Y09M
63000,63000030,63000030-021,2193,6223,2938,3285,107Y09M
63000,63000030,63000030-028,2617,7129,3331,3798,107Y09M
63000,63000030,63000030-015,3758,8410,4154,4256,107Y09M
63000,63000030,63000030-011,2342,6142,2840,3302,107Y09M
63000,63000030,63000030-041,1670,4636,2151,2485,107Y09M
63000,63000030,63000030-012,2063,5151,2373,2778,107Y09M
63000,63000030,63000030-026,1456,3554,1668,1886,107Y09M
63000,63000030,63000030-040,3577,10346,4905,5441,107Y09M
63000,63000030,63000030-027,1888,4958,2278,2680,107Y09M
63000,63000030,63000030-022,2855,6978,3231,3747,107Y09M
63000,63000030,63000030-033,1756,4244,2003,2241,107Y09M
63000,63000040,63000040-039,2722,6172,2866,3306,107Y09M
63000,63000040,63000040-027,3007,7689,3594,4095,107Y09M
63000,63000040,63000040-017,427,1144,626,518,107Y09M
63000,63000040,63000040-014,3605,9723,4599,5124,107Y09M
63000,63000040,63000040-006,3802,6848,2935,3913,107Y09M
63000,63000040,63000040-033,1576,3868,1815,2053,107Y09M
63000,63000040,63000040-030,2357,5846,2781,3065,107Y09M
63000,63000040,63000040-023,2352,5255,2501,2754,107Y09M
63000,63000040,63000040-031,2271,5224,2460,2764,107Y09M
63000,63000040,63000040-042,1016,2731,1305,1426,107Y09M
63000,63000040,63000040-001,1415,3282,1566,1716,107Y09M
63000,63000040,63000040-003,2000,3695,1624,2071,107Y09M
63000,63000040,63000040-002,2825,5399,2342,3057,107Y09M
63000,63000040,63000040-004,2147,4651,2204,2447,107Y09M
63000,63000040,63000040-016,3879,9918,4591,5327,107Y09M
63000,63000040,63000040-015,2997,7244,3322,3922,107Y09M
63000,63000040,63000040-038,1342,2900,1316,1584,107Y09M
63000,63000040,63000040-036,2254,4691,2145,2546,107Y09M
63000,63000040,63000040-034,2535,6126,2848,3278,107Y09M
63000,63000040,63000040-029,3125,7776,3711,4065,107Y09M
63000,63000040,63000040-028,2868,7166,3354,3812,107Y09M
63000,63000040,63000040-025,3066,8452,4026,4426,107Y09M
63000,63000040,63000040-026,1626,4228,2017,2211,107Y09M
63000,63000040,63000040-024,3890,7624,3927,3697,107Y09M
63000,63000040,63000040-021,2621,6750,3165,3585,107Y09M
63000,63000040,63000040-041,3454,8040,3872,4168,107Y09M
63000,63000040,63000040-010,2597,5015,2157,2858,107Y09M
63000,63000040,63000040-037,1556,3424,1661,1763,107Y09M
63000,63000040,63000040-005,1542,2637,1112,1525,107Y09M
63000,63000040,63000040-040,2197,4864,2234,2630,107Y09M
63000,63000040,63000040-011,2976,5621,2475,3146,107Y09M
63000,63000040,63000040-008,3298,7452,3359,4093,107Y09M
63000,63000040,63000040-012,1972,4381,1999,2382,107Y09M
63000,63000040,63000040-022,2184,5045,2340,2705,107Y09M
63000,63000040,63000040-019,2208,5204,2462,2742,107Y09M
63000,63000040,63000040-018,2181,5514,2588,2926,107Y09M
63000,63000040,63000040-020,2237,5291,2432,2859,107Y09M
63000,63000040,63000040-007,2404,4294,1853,2441,107Y09M
63000,63000040,63000040-009,2026,4074,1858,2216,107Y09M
63000,63000040,63000040-013,1446,3901,1880,2021,107Y09M
63000,63000040,63000040-032,2488,5438,2522,2916,107Y09M
63000,63000040,63000040-035,2125,5089,2348,2741,107Y09M
63000,63000050,63000050-031,3547,8993,4140,4853,107Y09M
63000,63000050,63000050-029,2325,5791,2762,3029,107Y09M
63000,63000050,63000050-003,1070,2379,1154,1225,107Y09M
63000,63000050,63000050-030,3152,8515,3997,4518,107Y09M
63000,63000050,63000050-001,1398,3060,1430,1630,107Y09M
63000,63000050,63000050-011,2544,6465,3142,3323,107Y09M
63000,63000050,63000050-012,2094,5105,2518,2587,107Y09M
63000,63000050,63000050-023,1871,4017,1878,2139,107Y09M
63000,63000050,63000050-027,1933,4560,2156,2404,107Y09M
63000,63000050,63000050-026,2875,5908,3008,2900,107Y09M
63000,63000050,63000050-014,3032,6595,3105,3490,107Y09M
63000,63000050,63000050-028,1675,4145,1981,2164,107Y09M
63000,63000050,63000050-004,2072,4780,2271,2509,107Y09M
63000,63000050,63000050-008,1513,3373,1582,1791,107Y09M
63000,63000050,63000050-005,2023,4667,2230,2437,107Y09M
63000,63000050,63000050-017,1061,2904,1373,1531,107Y09M
63000,63000050,63000050-019,4569,11459,5526,5933,107Y09M
63000,63000050,63000050-022,740,1828,829,999,107Y09M
63000,63000050,63000050-025,1406,3225,1525,1700,107Y09M
63000,63000050,63000050-006,2825,6147,2840,3307,107Y09M
63000,63000050,63000050-002,1080,2710,1327,1383,107Y09M
63000,63000050,63000050-015,1861,4928,2372,2556,107Y09M
63000,63000050,63000050-016,1367,3490,1586,1904,107Y09M
63000,63000050,63000050-021,3643,10160,4908,5252,107Y09M
63000,63000050,63000050-007,2520,5931,2752,3179,107Y09M
63000,63000050,63000050-024,1656,3476,1696,1780,107Y09M
63000,63000050,63000050-009,2477,5646,2707,2939,107Y09M
63000,63000050,63000050-010,1827,4452,2148,2304,107Y09M
63000,63000050,63000050-018,1346,3705,1815,1890,107Y09M
63000,63000050,63000050-020,2441,6251,3022,3229,107Y09M
63000,63000050,63000050-013,1614,4401,2120,2281,107Y09M
63000,63000100,63000100-012,2182,5710,2659,3051,107Y09M
63000,63000100,63000100-022,4155,11844,5645,6199,107Y09M
63000,63000100,63000100-009,2705,6243,2846,3397,107Y09M
63000,63000100,63000100-025,1840,4951,2401,2550,107Y09M
63000,63000100,63000100-028,2004,4191,1980,2211,107Y09M
63000,63000100,63000100-033,2116,5786,2767,3019,107Y09M
63000,63000100,63000100-031,2742,8320,3977,4343,107Y09M
63000,63000100,63000100-027,2842,7056,3492,3564,107Y09M
63000,63000100,63000100-003,2597,6820,3233,3587,107Y09M
63000,63000100,63000100-002,3844,9725,4636,5089,107Y09M
63000,63000100,63000100-001,2839,7426,3586,3840,107Y09M
63000,63000100,63000100-032,2456,6423,3098,3325,107Y09M
63000,63000100,63000100-036,2019,6032,2861,3171,107Y09M
63000,63000100,63000100-023,2870,8103,3921,4182,107Y09M
63000,63000100,63000100-034,3961,10557,4931,5626,107Y09M
63000,63000100,63000100-014,2609,7026,3298,3728,107Y09M
63000,63000100,63000100-013,2085,5570,2734,2836,107Y09M
63000,63000100,63000100-040,2234,6101,2827,3274,107Y09M
63000,63000100,63000100-035,3206,9582,4609,4973,107Y09M
63000,63000100,63000100-017,3743,8857,4101,4756,107Y09M
63000,63000100,63000100-006,2176,5958,2865,3093,107Y09M
63000,63000100,63000100-007,3632,10048,4800,5248,107Y09M
63000,63000100,63000100-008,3360,9731,4642,5089,107Y09M
63000,63000100,63000100-005,2383,6423,3020,3403,107Y09M
63000,63000100,63000100-030,2124,5696,2737,2959,107Y09M
63000,63000100,63000100-029,4094,8855,4412,4443,107Y09M
63000,63000100,63000100-010,3343,8709,4083,4626,107Y09M
63000,63000100,63000100-011,3059,8262,3992,4270,107Y09M
63000,63000100,63000100-019,3198,8386,4025,4361,107Y09M
63000,63000100,63000100-016,2304,6113,2939,3174,107Y09M
63000,63000100,63000100-026,3640,8525,4102,4423,107Y09M
63000,63000100,63000100-021,1794,4782,2237,2545,107Y09M
63000,63000100,63000100-020,3169,7996,3788,4208,107Y09M
63000,63000100,63000100-018,2763,7891,3755,4136,107Y09M
63000,63000100,63000100-015,2737,7340,3566,3774,107Y09M
63000,63000100,63000100-024,3169,9089,4359,4730,107Y09M
63000,63000100,63000100-038,2355,6402,3038,3364,107Y09M
63000,63000100,63000100-039,3867,9177,4421,4756,107Y09M
63000,63000100,63000100-037,510,1412,756,656,107Y09M
63000,63000080,63000080-027,3605,9217,4334,4883,107Y09M
63000,63000080,63000080-028,4570,10524,5307,5217,107Y09M
63000,63000080,63000080-037,367,970,499,471,107Y09M
63000,63000080,63000080-038,1737,4159,1983,2176,107Y09M
63000,63000080,63000080-025,1641,4406,2120,2286,107Y09M
63000,63000080,63000080-026,2806,7077,3388,3689,107Y09M
63000,63000080,63000080-036,1741,4112,2122,1990,107Y09M
63000,63000080,63000080-040,2976,8082,3897,4185,107Y09M
63000,63000080,63000080-034,2273,6121,2944,3177,107Y09M
63000,63000080,63000080-005,2134,5404,2576,2828,107Y09M
63000,63000080,63000080-001,3318,8047,3774,4273,107Y09M
63000,63000080,63000080-002,2974,7724,3617,4107,107Y09M
63000,63000080,63000080-003,2068,5448,2542,2906,107Y09M
63000,63000080,63000080-006,2297,6174,2893,3281,107Y09M
63000,63000080,63000080-004,2567,6985,3317,3668,107Y09M
63000,63000080,63000080-024,3639,9394,4525,4869,107Y09M
63000,63000080,63000080-029,2941,7942,3848,4094,107Y09M
63000,63000080,63000080-010,2285,5535,2670,2865,107Y09M
63000,63000080,63000080-007,2222,5890,2833,3057,107Y09M
63000,63000080,63000080-011,1434,3413,1622,1791,107Y09M
63000,63000080,63000080-033,3171,8232,3890,4342,107Y09M
63000,63000080,63000080-039,2924,7600,3651,3949,107Y09M
63000,63000080,63000080-012,2053,4812,2321,2491,107Y09M
63000,63000080,63000080-008,1877,4731,2253,2478,107Y09M
63000,63000080,63000080-009,2891,7595,3571,4024,107Y09M
63000,63000080,63000080-035,3295,8860,4296,4564,107Y09M
63000,63000080,63000080-023,2842,7200,3449,3751,107Y09M
63000,63000080,63000080-041,2324,6418,3145,3273,107Y09M
63000,63000080,63000080-030,3261,8816,4316,4500,107Y09M
63000,63000080,63000080-031,2203,5894,2795,3099,107Y09M
63000,63000080,63000080-032,2139,5997,2888,3109,107Y09M
63000,63000080,63000080-043,1876,5169,2456,2713,107Y09M
63000,63000080,63000080-014,1482,3492,1601,1891,107Y09M
63000,63000080,63000080-018,2747,6975,3291,3684,107Y09M
63000,63000080,63000080-042,2165,5101,2416,2685,107Y09M
63000,63000080,63000080-020,3469,8701,4166,4535,107Y09M
63000,63000080,63000080-022,2842,7001,3309,3692,107Y09M
63000,63000080,63000080-015,2951,7818,3806,4012,107Y09M
63000,63000080,63000080-021,1705,4057,1939,2118,107Y09M
63000,63000080,63000080-016,2413,6107,2930,3177,107Y09M
63000,63000080,63000080-017,2157,5589,2658,2931,107Y09M
63000,63000080,63000080-019,2152,6073,2899,3174,107Y09M
63000,63000080,63000080-013,2074,5072,2429,2643,107Y09M
63000,63000120,63000120-037,2842,7826,3826,4000,107Y09M
63000,63000120,63000120-018,2209,5740,2792,2948,107Y09M
63000,63000120,63000120-041,424,1265,669,596,107Y09M
63000,63000120,63000120-024,2384,6088,2981,3107,107Y09M
63000,63000120,63000120-027,3111,6645,3070,3575,107Y09M
63000,63000120,63000120-022,3431,8938,4288,4650,107Y09M
63000,63000120,63000120-030,1956,5117,2470,2647,107Y09M
63000,63000120,63000120-028,1751,4478,2173,2305,107Y09M
63000,63000120,63000120-033,1673,4523,2205,2318,107Y09M
63000,63000120,63000120-002,1732,4402,2119,2283,107Y09M
63000,63000120,63000120-009,3738,9625,4571,5054,107Y09M
63000,63000120,63000120-011,1910,5360,2521,2839,107Y09M
63000,63000120,63000120-010,3511,8406,3906,4500,107Y09M
63000,63000120,63000120-003,2096,5451,2593,2858,107Y09M
63000,63000120,63000120-017,3423,9663,4637,5026,107Y09M
63000,63000120,63000120-016,2071,5905,2826,3079,107Y09M
63000,63000120,63000120-013,2633,7624,3630,3994,107Y09M
63000,63000120,63000120-014,1956,5673,2690,2983,107Y09M
63000,63000120,63000120-032,1228,3381,1646,1735,107Y09M
63000,63000120,63000120-020,4046,10470,5103,5367,107Y09M
63000,63000120,63000120-012,1646,4707,2210,2497,107Y09M
63000,63000120,63000120-026,1460,3181,1558,1623,107Y09M
63000,63000120,63000120-023,2743,6564,3027,3537,107Y09M
63000,63000120,63000120-001,1769,4388,2099,2289,107Y09M
63000,63000120,63000120-039,862,2450,1288,1162,107Y09M
63000,63000120,63000120-019,764,2040,1027,1013,107Y09M
63000,63000120,63000120-008,2913,7961,3745,4216,107Y09M
63000,63000120,63000120-036,2347,6268,3055,3213,107Y09M
63000,63000120,63000120-021,4243,9639,4904,4735,107Y09M
63000,63000120,63000120-015,1782,5089,2395,2694,107Y09M
63000,63000120,63000120-031,2320,6395,3055,3340,107Y09M
63000,63000120,63000120-040,699,1700,880,820,107Y09M
63000,63000120,63000120-042,381,987,535,452,107Y09M
63000,63000120,63000120-029,2656,6810,3252,3558,107Y09M
63000,63000120,63000120-025,2816,6882,3269,3613,107Y09M
63000,63000120,63000120-007,3136,8050,3812,4238,107Y09M
63000,63000120,63000120-005,2822,8083,3837,4246,107Y09M
63000,63000120,63000120-006,2962,7733,3622,4111,107Y09M
63000,63000120,63000120-004,2748,7648,3618,4030,107Y09M
63000,63000120,63000120-035,2218,5682,2818,2864,107Y09M
63000,63000120,63000120-034,1700,4799,2341,2458,107Y09M
63000,63000120,63000120-038,4237,11858,5867,5991,107Y09M
63000,63000010,63000010-004,2937,7071,3276,3795,107Y09M
63000,63000010,63000010-026,3922,10538,4920,5618,107Y09M
63000,63000010,63000010-027,1729,4479,2079,2400,107Y09M
63000,63000010,63000010-015,2559,6703,3112,3591,107Y09M
63000,63000010,63000010-009,1785,4788,2260,2528,107Y09M
63000,63000010,63000010-016,3512,9008,4165,4843,107Y09M
63000,63000010,63000010-017,2676,6466,3065,3401,107Y09M
63000,63000010,63000010-029,1566,4183,1967,2216,107Y09M
63000,63000010,63000010-022,3445,8649,4031,4618,107Y09M
63000,63000010,63000010-019,3678,8639,4129,4510,107Y09M
63000,63000010,63000010-021,3896,10218,4815,5403,107Y09M
63000,63000010,63000010-011,3036,7247,3402,3845,107Y09M
63000,63000010,63000010-013,1057,2924,1364,1560,107Y09M
63000,63000010,63000010-014,1830,4543,2112,2431,107Y09M
63000,63000010,63000010-003,3050,8330,3850,4480,107Y09M
63000,63000010,63000010-035,1475,3690,1693,1997,107Y09M
63000,63000010,63000010-028,1349,3731,1769,1962,107Y09M
63000,63000010,63000010-002,2066,5475,2639,2836,107Y09M
63000,63000010,63000010-008,2031,4784,2085,2699,107Y09M
63000,63000010,63000010-006,2130,5326,2450,2876,107Y09M
63000,63000010,63000010-032,1836,4771,2268,2503,107Y09M
63000,63000010,63000010-025,2569,6572,3102,3470,107Y09M
63000,63000010,63000010-033,2619,6620,3036,3584,107Y09M
63000,63000010,63000010-031,1250,3404,1626,1778,107Y09M
63000,63000010,63000010-030,2586,7338,3478,3860,107Y09M
63000,63000010,63000010-018,4072,8109,4023,4086,107Y09M
63000,63000010,63000010-007,2012,5112,2409,2703,107Y09M
63000,63000010,63000010-005,1855,4697,2246,2451,107Y09M
63000,63000010,63000010-024,3376,8269,3846,4423,107Y09M
63000,63000010,63000010-034,1002,2754,1264,1490,107Y09M
63000,63000010,63000010-010,1767,4627,2150,2477,107Y09M
63000,63000010,63000010-012,4307,11158,5204,5954,107Y09M
63000,63000010,63000010-020,2187,5584,2681,2903,107Y09M
63000,63000020,63000020-030,3689,9160,4379,4781,107Y09M
63000,63000020,63000020-031,2172,5354,2517,2837,107Y09M
63000,63000020,63000020-027,1645,4110,1966,2144,107Y09M
63000,63000020,63000020-026,2435,6223,3021,3202,107Y09M
63000,63000020,63000020-025,2979,8238,4036,4202,107Y09M
63000,63000020,63000020-024,1683,4538,2217,2321,107Y09M
63000,63000020,63000020-004,1757,3587,1580,2007,107Y09M
63000,63000020,63000020-013,2029,5074,2401,2673,107Y09M
63000,63000020,63000020-012,1462,3788,1838,1950,107Y09M
63000,63000020,63000020-032,2817,6913,3287,3626,107Y09M
63000,63000020,63000020-010,1409,3898,1892,2006,107Y09M
63000,63000020,63000020-016,2217,5730,2825,2905,107Y09M
63000,63000020,63000020-017,2165,5444,2605,2839,107Y09M
63000,63000020,63000020-002,1930,4782,2191,2591,107Y09M
63000,63000020,63000020-014,1451,4132,2082,2050,107Y09M
63000,63000020,63000020-018,1994,5108,2474,2634,107Y09M
63000,63000020,63000020-009,4433,11113,5251,5862,107Y09M
63000,63000020,63000020-001,2919,5944,3040,2904,107Y09M
63000,63000020,63000020-022,2566,7141,3373,3768,107Y09M
63000,63000020,63000020-023,2094,5002,2408,2594,107Y09M
63000,63000020,63000020-021,874,2288,1128,1160,107Y09M
63000,63000020,63000020-015,1743,4414,2136,2278,107Y09M
63000,63000020,63000020-033,3131,8038,3814,4224,107Y09M
63000,63000020,63000020-020,3052,8151,3879,4272,107Y09M
63000,63000020,63000020-019,1970,4553,2119,2434,107Y09M
63000,63000020,63000020-029,2654,6763,3279,3484,107Y09M
63000,63000020,63000020-007,2304,5353,2478,2875,107Y09M
63000,63000020,63000020-035,1692,4171,2009,2162,107Y09M
63000,63000020,63000020-028,2176,5295,2458,2837,107Y09M
63000,63000020,63000020-034,1917,4643,2176,2467,107Y09M
63000,63000020,63000020-011,2106,5126,2503,2623,107Y09M
63000,63000020,63000020-005,1392,3487,1635,1852,107Y09M
63000,63000020,63000020-037,1312,3227,1485,1742,107Y09M
63000,63000020,63000020-008,3152,8254,3853,4401,107Y09M
63000,63000020,63000020-039,2991,7191,3387,3804,107Y09M
63000,63000020,63000020-041,920,2073,1005,1068,107Y09M
63000,63000020,63000020-040,2019,4964,2335,2629,107Y09M
63000,63000020,63000020-038,1771,4157,1987,2170,107Y09M
63000,63000020,63000020-003,1236,2912,1350,1562,107Y09M
63000,63000020,63000020-006,2471,5879,2744,3135,107Y09M
63000,63000020,63000020-036,2932,7333,3475,3858,107Y09M
63000,63000090,63000090-018,2498,6698,3308,3390,107Y09M
63000,63000090,63000090-004,3574,7846,3814,4032,107Y09M
63000,63000090,63000090-002,1512,3970,1975,1995,107Y09M
63000,63000090,63000090-017,3604,9869,4845,5024,107Y09M
63000,63000090,63000090-019,2261,5786,2831,2955,107Y09M
63000,63000090,63000090-009,2008,5028,2434,2594,107Y09M
63000,63000090,63000090-010,2772,6956,3368,3588,107Y09M
63000,63000090,63000090-011,2962,7956,3824,4132,107Y09M
63000,63000090,63000090-014,2168,5630,2737,2893,107Y09M
63000,63000090,63000090-008,1852,5012,2461,2551,107Y09M
63000,63000090,63000090-007,1932,4903,2401,2502,107Y09M
63000,63000090,63000090-005,2803,7634,3737,3897,107Y09M
63000,63000090,63000090-001,2862,6755,3472,3283,107Y09M
63000,63000090,63000090-020,2412,5715,2738,2977,107Y09M
63000,63000090,63000090-006,1533,3910,1857,2053,107Y09M
63000,63000090,63000090-003,1572,4197,2086,2111,107Y09M
63000,63000090,63000090-012,1736,4416,2131,2285,107Y09M
63000,63000090,63000090-015,2020,5297,2583,2714,107Y09M
63000,63000090,63000090-013,1731,4658,2224,2434,107Y09M
63000,63000090,63000090-016,3525,9462,4633,4829,107Y09M
63000,63000070,63000070-009,2155,4867,2347,2520,107Y09M
63000,63000070,63000070-033,2463,5696,2770,2926,107Y09M
63000,63000070,63000070-020,1421,3836,1908,1928,107Y09M
63000,63000070,63000070-026,1748,4600,2314,2286,107Y09M
63000,63000070,63000070-003,2026,3883,1798,2085,107Y09M
63000,63000070,63000070-023,1255,3388,1688,1700,107Y09M
63000,63000070,63000070-016,2830,7115,3508,3607,107Y09M
63000,63000070,63000070-024,2729,7187,3569,3618,107Y09M
63000,63000070,63000070-034,2302,4933,2350,2583,107Y09M
63000,63000070,63000070-022,1779,4639,2305,2334,107Y09M
63000,63000070,63000070-006,2685,5875,2865,3010,107Y09M
63000,63000070,63000070-027,1295,3443,1684,1759,107Y09M
63000,63000070,63000070-019,2124,5395,2687,2708,107Y09M
63000,63000070,63000070-035,1657,3783,1790,1993,107Y09M
63000,63000070,63000070-011,2967,7421,3726,3695,107Y09M
63000,63000070,63000070-007,2215,5030,2449,2581,107Y09M
63000,63000070,63000070-010,3174,6142,3418,2724,107Y09M
63000,63000070,63000070-032,2432,6440,3131,3309,107Y09M
63000,63000070,63000070-018,3293,8885,4339,4546,107Y09M
63000,63000070,63000070-005,2774,6334,3173,3161,107Y09M
63000,63000070,63000070-021,2653,6318,3119,3199,107Y09M
63000,63000070,63000070-014,3433,8642,4143,4499,107Y09M
63000,63000070,63000070-013,1568,3517,1672,1845,107Y09M
63000,63000070,63000070-004,3016,6609,3108,3501,107Y09M
63000,63000070,63000070-002,1881,3474,1677,1797,107Y09M
63000,63000070,63000070-030,1984,5424,2673,2751,107Y09M
63000,63000070,63000070-029,1390,3753,1869,1884,107Y09M
63000,63000070,63000070-001,2745,5684,2691,2993,107Y09M
63000,63000070,63000070-008,1817,4084,1975,2109,107Y09M
63000,63000070,63000070-017,1748,4474,2188,2286,107Y09M
63000,63000070,63000070-028,1852,4862,2366,2496,107Y09M
63000,63000070,63000070-015,2229,5648,2811,2837,107Y09M
63000,63000070,63000070-031,1777,4950,2442,2508,107Y09M
63000,63000070,63000070-025,2176,5719,2791,2928,107Y09M
63000,63000070,63000070-012,1891,4828,2391,2437,107Y09M
63000,63000070,63000070-036,1339,3128,1502,1626,107Y09M
10014,10014100,10014100-001,355,896,473,423,107Y09M
10014,10014100,10014100-003,630,1549,805,744,107Y09M
10014,10014100,10014100-002,536,1362,735,627,107Y09M
10014,10014100,10014100-004,675,1652,837,815,107Y09M
10014,10014100,10014100-005,287,649,319,330,107Y09M
10014,10014090,10014090-002,278,700,384,316,107Y09M
10014,10014090,10014090-006,886,2077,1101,976,107Y09M
10014,10014090,10014090-004,302,636,373,263,107Y09M
10014,10014090,10014090-009,475,1058,557,501,107Y09M
10014,10014090,10014090-008,852,2010,1055,955,107Y09M
10014,10014090,10014090-001,547,1497,780,717,107Y09M
10014,10014090,10014090-007,381,906,507,399,107Y09M
10014,10014090,10014090-005,692,1626,822,804,107Y09M
10014,10014090,10014090-003,320,687,382,305,107Y09M
10014,10014020,10014020-003,618,1581,877,704,107Y09M
10014,10014020,10014020-004,1122,3091,1594,1497,107Y09M
10014,10014020,10014020-007,356,819,448,371,107Y09M
10014,10014020,10014020-006,922,2569,1347,1222,107Y09M
10014,10014020,10014020-002,476,1078,533,545,107Y09M
10014,10014020,10014020-005,769,2258,1160,1098,107Y09M
10014,10014020,10014020-008,787,2052,1094,958,107Y09M
10014,10014020,10014020-001,318,689,385,304,107Y09M
10014,10014060,10014060-003,143,359,196,163,107Y09M
10014,10014060,10014060-004,330,898,450,448,107Y09M
10014,10014060,10014060-010,192,489,264,225,107Y09M
10014,10014060,10014060-009,168,444,251,193,107Y09M
10014,10014060,10014060-007,380,979,541,438,107Y09M
10014,10014060,10014060-008,149,363,193,170,107Y09M
10014,10014060,10014060-001,521,1317,700,617,107Y09M
10014,10014060,10014060-005,889,2266,1099,1167,107Y09M
10014,10014060,10014060-002,272,721,375,346,107Y09M
10014,10014060,10014060-006,163,383,205,178,107Y09M
10014,10014040,10014040-010,1366,3478,1784,1694,107Y09M
10014,10014040,10014040-002,192,484,261,223,107Y09M
10014,10014040,10014040-011,467,1281,671,610,107Y09M
10014,10014040,10014040-005,517,1332,730,602,107Y09M
10014,10014040,10014040-012,500,1380,730,650,107Y09M
10014,10014040,10014040-006,538,1469,763,706,107Y09M
10014,10014040,10014040-007,497,1199,647,552,107Y09M
10014,10014040,10014040-009,519,1350,699,651,107Y09M
10014,10014040,10014040-003,243,556,314,242,107Y09M
10014,10014040,10014040-004,162,381,224,157,107Y09M
10014,10014040,10014040-013,547,1320,698,622,107Y09M
10014,10014040,10014040-001,210,552,297,255,107Y09M
10014,10014040,10014040-008,955,2534,1326,1208,107Y09M
10014,10014130,10014130-002,119,391,210,181,107Y09M
10014,10014130,10014130-001,227,735,395,340,107Y09M
10014,10014130,10014130-003,143,527,287,240,107Y09M
10014,10014130,10014130-005,363,1275,673,602,107Y09M
10014,10014130,10014130-004,222,731,387,344,107Y09M
10014,10014070,10014070-001,873,1751,1098,653,107Y09M
10014,10014070,10014070-004,129,297,169,128,107Y09M
10014,10014070,10014070-003,451,1106,596,510,107Y09M
10014,10014070,10014070-002,515,1346,723,623,107Y09M
10014,10014070,10014070-007,1009,2383,1273,1110,107Y09M
10014,10014070,10014070-005,280,599,316,283,107Y09M
10014,10014070,10014070-006,505,1033,541,492,107Y09M
10014,10014140,10014140-002,222,731,359,372,107Y09M
10014,10014140,10014140-001,186,650,329,321,107Y09M
10014,10014140,10014140-003,475,1549,783,766,107Y09M
10014,10014140,10014140-004,135,411,222,189,107Y09M
10014,10014140,10014140-005,125,397,191,206,107Y09M
10014,10014080,10014080-002,547,1312,771,541,107Y09M
10014,10014080,10014080-005,388,999,555,444,107Y09M
10014,10014080,10014080-003,237,623,375,248,107Y09M
10014,10014080,10014080-004,874,2257,1235,1022,107Y09M
10014,10014080,10014080-006,576,1337,785,552,107Y09M
10014,10014080,10014080-001,296,688,381,307,107Y09M
10014,10014120,10014120-006,154,623,346,277,107Y09M
10014,10014120,10014120-003,80,334,169,165,107Y09M
10014,10014120,10014120-005,203,717,395,322,107Y09M
10014,10014120,10014120-004,306,1213,648,565,107Y09M
10014,10014120,10014120-001,252,972,494,478,107Y09M
10014,10014120,10014120-002,97,341,177,164,107Y09M
10014,10014050,10014050-004,624,1644,894,750,107Y09M
10014,10014050,10014050-006,486,1267,644,623,107Y09M
10014,10014050,10014050-001,272,764,402,362,107Y09M
10014,10014050,10014050-005,403,1014,545,469,107Y09M
10014,10014050,10014050-003,376,997,504,493,107Y09M
10014,10014050,10014050-002,403,1005,544,461,107Y09M
10014,10014050,10014050-007,475,1208,647,561,107Y09M
10014,10014150,10014150-002,345,1023,556,467,107Y09M
10014,10014150,10014150-001,274,719,390,329,107Y09M
10014,10014150,10014150-004,319,676,374,302,107Y09M
10014,10014150,10014150-006,147,332,166,166,107Y09M
10014,10014150,10014150-005,207,486,262,224,107Y09M
10014,10014150,10014150-003,153,388,218,170,107Y09M
10014,10014110,10014110-002,354,1230,646,584,107Y09M
10014,10014110,10014110-001,327,1185,675,510,107Y09M
10014,10014110,10014110-003,472,1671,853,818,107Y09M
10014,10014010,10014010-021,360,885,431,454,107Y09M
10014,10014010,10014010-024,370,1002,484,518,107Y09M
10014,10014010,10014010-011,1375,4089,2018,2071,107Y09M
10014,10014010,10014010-020,371,877,442,435,107Y09M
10014,10014010,10014010-015,740,1898,958,940,107Y09M
10014,10014010,10014010-019,333,799,420,379,107Y09M
10014,10014010,10014010-023,499,1345,667,678,107Y09M
10014,10014010,10014010-014,306,776,412,364,107Y09M
10014,10014010,10014010-008,1456,3571,1755,1816,107Y09M
10014,10014010,10014010-013,719,2372,1144,1228,107Y09M
10014,10014010,10014010-018,401,1021,537,484,107Y09M
10014,10014010,10014010-034,892,2643,1341,1302,107Y09M
10014,10014010,10014010-032,1315,3398,1568,1830,107Y09M
10014,10014010,10014010-022,391,914,454,460,107Y09M
10014,10014010,10014010-012,1837,5296,2521,2775,107Y09M
10014,10014010,10014010-005,1230,3169,1584,1585,107Y09M
10014,10014010,10014010-003,1079,2385,1239,1146,107Y09M
10014,10014010,10014010-036,1358,3598,1748,1850,107Y09M
10014,10014010,10014010-045,580,1529,782,747,107Y09M
10014,10014010,10014010-004,1165,3054,1560,1494,107Y09M
10014,10014010,10014010-006,1129,3077,1606,1471,107Y09M
10014,10014010,10014010-042,600,1606,846,760,107Y09M
10014,10014010,10014010-017,611,1461,763,698,107Y09M
10014,10014010,10014010-044,564,1464,750,714,107Y09M
10014,10014010,10014010-046,856,2286,1199,1087,107Y09M
10014,10014010,10014010-043,403,1044,534,510,107Y09M
10014,10014010,10014010-010,1206,3774,1763,2011,107Y09M
10014,10014010,10014010-035,591,1581,847,734,107Y09M
10014,10014010,10014010-016,275,721,379,342,107Y09M
10014,10014010,10014010-001,660,1696,908,788,107Y09M
10014,10014010,10014010-002,397,972,517,455,107Y09M
10014,10014010,10014010-025,300,683,351,332,107Y09M
10014,10014010,10014010-027,199,465,238,227,107Y09M
10014,10014010,10014010-007,3029,7546,3676,3870,107Y09M
10014,10014010,10014010-029,757,1864,999,865,107Y09M
10014,10014010,10014010-037,477,1141,556,585,107Y09M
10014,10014010,10014010-026,361,1062,523,539,107Y09M
10014,10014010,10014010-030,875,2419,1217,1202,107Y09M
10014,10014010,10014010-031,1360,3412,1748,1664,107Y09M
10014,10014010,10014010-039,2102,5914,2989,2925,107Y09M
10014,10014010,10014010-040,943,2739,1439,1300,107Y09M
10014,10014010,10014010-041,476,1433,771,662,107Y09M
10014,10014010,10014010-038,3689,9347,4489,4858,107Y09M
10014,10014010,10014010-033,576,1777,912,865,107Y09M
10014,10014010,10014010-009,410,1021,507,514,107Y09M
10014,10014010,10014010-028,199,463,222,241,107Y09M
10014,10014030,10014030-004,349,978,496,482,107Y09M
10014,10014030,10014030-007,322,825,453,372,107Y09M
10014,10014030,10014030-005,723,2004,993,1011,107Y09M
10014,10014030,10014030-003,386,1045,557,488,107Y09M
10014,10014030,10014030-006,225,611,356,255,107Y09M
10014,10014030,10014030-001,685,1903,1003,900,107Y09M
10014,10014030,10014030-002,474,1372,690,682,107Y09M
10014,10014160,10014160-001,524,1533,756,777,107Y09M
10014,10014160,10014160-003,583,1459,753,706,107Y09M
10014,10014160,10014160-002,337,932,459,473,107Y09M
10014,10014160,10014160-004,428,1177,608,569,107Y09M
67000,67000150,67000150-010,321,1076,548,528,107Y09M
67000,67000150,67000150-023,524,1537,819,718,107Y09M
67000,67000150,67000150-022,484,1528,805,723,107Y09M
67000,67000150,67000150-012,1062,3182,1608,1574,107Y09M
67000,67000150,67000150-002,290,718,373,345,107Y09M
67000,67000150,67000150-017,294,754,374,380,107Y09M
67000,67000150,67000150-021,351,1116,582,534,107Y09M
67000,67000150,67000150-011,326,946,496,450,107Y09M
67000,67000150,67000150-018,499,1429,707,722,107Y09M
67000,67000150,67000150-006,238,509,293,216,107Y09M
67000,67000150,67000150-001,427,1141,598,543,107Y09M
67000,67000150,67000150-005,360,870,482,388,107Y09M
67000,67000150,67000150-009,194,394,195,199,107Y09M
67000,67000150,67000150-019,719,2105,1065,1040,107Y09M
67000,67000150,67000150-015,766,2215,1174,1041,107Y09M
67000,67000150,67000150-004,336,989,507,482,107Y09M
67000,67000150,67000150-008,659,1843,941,902,107Y09M
67000,67000150,67000150-007,196,497,268,229,107Y09M
67000,67000080,67000080-001,738,1799,930,869,107Y09M
67000,67000080,67000080-017,729,1762,926,836,107Y09M
67000,67000080,67000080-002,807,2307,1175,1132,107Y09M
67000,67000080,67000080-003,683,1843,964,879,107Y09M
67000,67000080,67000080-012,374,991,555,436,107Y09M
67000,67000080,67000080-004,663,1822,934,888,107Y09M
67000,67000080,67000080-018,1003,2561,1308,1253,107Y09M
67000,67000080,67000080-016,933,2544,1342,1202,107Y09M
67000,67000080,67000080-013,576,1478,782,696,107Y09M
67000,67000080,67000080-011,760,2144,1096,1048,107Y09M
67000,67000080,67000080-005,870,2330,1151,1179,107Y09M
67000,67000080,67000080-006,924,2388,1203,1185,107Y09M
67000,67000110,67000110-009,407,917,521,396,107Y09M
67000,67000110,67000110-005,351,883,453,430,107Y09M
67000,67000110,67000110-004,404,1024,561,463,107Y09M
67000,67000110,67000110-006,240,721,395,326,107Y09M
67000,67000110,67000110-002,288,708,382,326,107Y09M
67000,67000110,67000110-003,637,1671,854,817,107Y09M
67000,67000110,67000110-001,468,1139,601,538,107Y09M
67000,67000110,67000110-010,256,656,363,293,107Y09M
67000,67000110,67000110-007,441,1080,612,468,107Y09M
67000,67000110,67000110-008,348,853,471,382,107Y09M
67000,67000220,67000220-003,443,1136,587,549,107Y09M
67000,67000220,67000220-006,153,405,216,189,107Y09M
67000,67000220,67000220-005,233,596,315,281,107Y09M
67000,67000220,67000220-001,733,1930,998,932,107Y09M
67000,67000220,67000220-002,647,1737,921,816,107Y09M
67000,67000220,67000220-004,372,1088,545,543,107Y09M
67000,67000220,67000220-007,149,445,239,206,107Y09M
67000,67000370,67000370-031,1171,2995,1419,1576,107Y09M
67000,67000370,67000370-042,1577,3725,1771,1954,107Y09M
67000,67000370,67000370-043,1059,2331,1179,1152,107Y09M
67000,67000370,67000370-016,1263,3093,1444,1649,107Y09M
67000,67000370,67000370-025,1488,4163,1997,2166,107Y09M
67000,67000370,67000370-048,1716,4298,2084,2214,107Y09M
67000,67000370,67000370-033,2438,6478,3017,3461,107Y09M
67000,67000370,67000370-034,2004,5714,2865,2849,107Y09M
67000,67000370,67000370-044,1926,4487,2389,2098,107Y09M
67000,67000370,67000370-005,1940,4592,2265,2327,107Y09M
67000,67000370,67000370-046,984,2239,1123,1116,107Y09M
67000,67000370,67000370-009,1365,3693,1591,2102,107Y09M
67000,67000370,67000370-041,1311,3306,1506,1800,107Y09M
67000,67000370,67000370-040,1595,3958,1964,1994,107Y09M
67000,67000370,67000370-047,1925,4574,2313,2261,107Y09M
67000,67000370,67000370-039,1993,4237,1996,2241,107Y09M
67000,67000370,67000370-007,1581,4147,1897,2250,107Y09M
67000,67000370,67000370-045,1408,2840,1383,1457,107Y09M
67000,67000370,67000370-011,1272,3254,1592,1662,107Y09M
67000,67000370,67000370-022,1596,3868,1892,1976,107Y09M
67000,67000270,67000270-003,1134,3152,1620,1532,107Y09M
67000,67000270,67000270-015,901,2436,1241,1195,107Y09M
67000,67000270,67000270-008,2470,6981,3513,3468,107Y09M
67000,67000270,67000270-002,1145,3194,1649,1545,107Y09M
67000,67000270,67000270-016,864,2447,1250,1197,107Y09M
67000,67000270,67000270-017,1062,3055,1624,1431,107Y09M
67000,67000270,67000270-013,783,1546,773,773,107Y09M
67000,67000270,67000270-014,610,1439,727,712,107Y09M
67000,67000270,67000270-005,3859,10613,5333,5280,107Y09M
67000,67000270,67000270-004,3349,8853,4526,4327,107Y09M
67000,67000270,67000270-001,2202,6265,3112,3153,107Y09M
67000,67000270,67000270-019,944,2630,1350,1280,107Y09M
67000,67000270,67000270-012,2092,5316,2659,2657,107Y09M
67000,67000270,67000270-011,1220,3220,1643,1577,107Y09M
67000,67000270,67000270-007,3822,10759,5346,5413,107Y09M
67000,67000270,67000270-006,1424,3867,1937,1930,107Y09M
67000,67000090,67000090-005,806,2257,1176,1081,107Y09M
67000,67000090,67000090-006,1295,3959,2045,1914,107Y09M
67000,67000090,67000090-012,341,672,370,302,107Y09M
67000,67000090,67000090-008,662,1788,929,859,107Y09M
67000,67000090,67000090-001,1191,3440,1698,1742,107Y09M
67000,67000090,67000090-007,787,2478,1274,1204,107Y09M
67000,67000090,67000090-011,324,840,486,354,107Y09M
67000,67000090,67000090-002,1075,3173,1627,1546,107Y09M
67000,67000090,67000090-003,572,1584,801,783,107Y09M
67000,67000090,67000090-010,243,661,353,308,107Y09M
67000,67000090,67000090-009,510,1350,716,634,107Y09M
67000,67000170,67000170-007,483,1385,701,684,107Y09M
67000,67000170,67000170-015,566,1400,731,669,107Y09M
67000,67000170,67000170-005,378,928,466,462,107Y09M
67000,67000170,67000170-013,360,966,458,508,107Y09M
67000,67000170,67000170-009,356,805,428,377,107Y09M
67000,67000170,67000170-001,538,1534,781,753,107Y09M
67000,67000170,67000170-014,554,1667,818,849,107Y09M
67000,67000170,67000170-011,309,835,395,440,107Y09M
67000,67000170,67000170-006,473,1063,560,503,107Y09M
67000,67000170,67000170-002,206,517,270,247,107Y09M
67000,67000340,67000340-005,1048,2806,1396,1410,107Y09M
67000,67000340,67000340-048,2474,5530,2585,2945,107Y09M
67000,67000340,67000340-042,1411,4289,2086,2203,107Y09M
67000,67000340,67000340-026,2098,6379,3164,3215,107Y09M
67000,67000340,67000340-049,1482,3494,1749,1745,107Y09M
67000,67000340,67000340-018,1765,4933,2416,2517,107Y09M
67000,67000340,67000340-047,1732,4534,2263,2271,107Y09M
67000,67000340,67000340-032,688,1615,786,829,107Y09M
67000,67000340,67000340-008,1037,2309,1093,1216,107Y09M
67000,67000340,67000340-056,1252,3911,1887,2024,107Y09M
67000,67000340,67000340-038,2332,4578,2031,2547,107Y09M
67000,67000340,67000340-033,1048,2037,969,1068,107Y09M
67000,67000340,67000340-025,1455,4337,2138,2199,107Y09M
67000,67000340,67000340-041,1232,3620,1786,1834,107Y09M
67000,67000340,67000340-046,2403,6119,3011,3108,107Y09M
67000,67000340,67000340-051,2136,4648,2476,2172,107Y09M
67000,67000340,67000340-023,1386,3587,1803,1784,107Y09M
67000,67000340,67000340-039,1286,3481,1727,1754,107Y09M
67000,67000340,67000340-054,1307,3109,1490,1619,107Y09M
67000,67000340,67000340-045,1644,3999,1920,2079,107Y09M
67000,67000340,67000340-024,1968,5501,2626,2875,107Y09M
67000,67000340,67000340-040,1961,5635,2673,2962,107Y09M
67000,67000340,67000340-020,2331,5822,2670,3152,107Y09M
67000,67000340,67000340-004,955,2492,1232,1260,107Y09M
67000,67000340,67000340-044,2021,4503,2185,2318,107Y09M
67000,67000340,67000340-050,1343,3258,1576,1682,107Y09M
67000,67000340,67000340-019,855,2065,1007,1058,107Y09M
67000,67000340,67000340-007,950,2189,1081,1108,107Y09M
67000,67000340,67000340-052,1465,4346,2058,2288,107Y09M
67000,67000340,67000340-001,1551,3893,1933,1960,107Y09M
67000,67000340,67000340-053,1977,5889,2828,3061,107Y09M
67000,67000340,67000340-043,1502,4412,2168,2244,107Y09M
67000,67000340,67000340-055,1010,2620,1266,1354,107Y09M
67000,67000260,67000260-010,98,204,125,79,107Y09M
67000,67000260,67000260-004,351,831,439,392,107Y09M
67000,67000260,67000260-006,180,426,251,175,107Y09M
67000,67000260,67000260-003,207,514,278,236,107Y09M
67000,67000260,67000260-001,186,417,234,183,107Y09M
67000,67000260,67000260-008,174,442,250,192,107Y09M
67000,67000260,67000260-009,125,337,199,138,107Y09M
67000,67000260,67000260-005,136,392,230,162,107Y09M
67000,67000260,67000260-002,273,707,381,326,107Y09M
67000,67000260,67000260-007,225,543,321,222,107Y09M
67000,67000310,67000310-043,1676,4444,2201,2243,107Y09M
67000,67000310,67000310-030,3325,9359,4608,4751,107Y09M
67000,67000310,67000310-009,572,1695,890,805,107Y09M
67000,67000310,67000310-032,1476,4025,2017,2008,107Y09M
67000,67000310,67000310-005,2383,6738,3240,3498,107Y09M
67000,67000310,67000310-012,1333,4099,2033,2066,107Y09M
67000,67000310,67000310-039,1340,3118,1522,1596,107Y09M
67000,67000310,67000310-025,1447,3880,1913,1967,107Y09M
67000,67000310,67000310-001,2625,6656,3081,3575,107Y09M
67000,67000310,67000310-031,2749,6490,3067,3423,107Y09M
67000,67000310,67000310-006,901,3028,1510,1518,107Y09M
67000,67000310,67000310-040,2019,6232,3118,3114,107Y09M
67000,67000310,67000310-017,1608,5024,2513,2511,107Y09M
67000,67000310,67000310-038,3066,9387,4633,4754,107Y09M
67000,67000310,67000310-042,1946,5475,2723,2752,107Y09M
67000,67000310,67000310-003,4213,10623,5428,5195,107Y09M
67000,67000310,67000310-011,960,2663,1298,1365,107Y09M
67000,67000310,67000310-028,277,589,296,293,107Y09M
67000,67000310,67000310-034,2379,5844,2729,3115,107Y09M
67000,67000310,67000310-024,1036,2386,1146,1240,107Y09M
67000,67000310,67000310-023,2415,7356,3687,3669,107Y09M
67000,67000310,67000310-035,1333,3616,1699,1917,107Y09M
67000,67000310,67000310-014,2868,8656,4202,4454,107Y09M
67000,67000310,67000310-036,1618,4471,2237,2234,107Y09M
67000,67000310,67000310-033,3209,7757,3766,3991,107Y09M
67000,67000310,67000310-013,1382,4223,2149,2074,107Y09M
67000,67000310,67000310-015,1501,4505,2292,2213,107Y09M
67000,67000310,67000310-021,950,2051,999,1052,107Y09M
67000,67000310,67000310-004,3045,9127,4523,4604,107Y09M
67000,67000310,67000310-007,1131,3327,1670,1657,107Y09M
67000,67000310,67000310-022,564,1338,618,720,107Y09M
67000,67000310,67000310-016,2413,6998,3479,3519,107Y09M
67000,67000310,67000310-026,3657,8979,4266,4713,107Y09M
67000,67000310,67000310-020,3754,9772,4818,4954,107Y09M
67000,67000310,67000310-037,3997,10978,5411,5567,107Y09M
67000,67000310,67000310-019,965,2240,1091,1149,107Y09M
67000,67000310,67000310-018,767,2503,1272,1231,107Y09M
67000,67000310,67000310-002,2988,8281,4029,4252,107Y09M
67000,67000310,67000310-008,755,2182,1095,1087,107Y09M
67000,67000310,67000310-041,1593,4647,2322,2325,107Y09M
67000,67000310,67000310-027,2466,7439,3768,3671,107Y09M
67000,67000310,67000310-010,2160,5766,2816,2950,107Y09M
67000,67000310,67000310-029,2363,6940,3504,3436,107Y09M
67000,67000230,67000230-007,298,849,453,396,107Y09M
67000,67000230,67000230-006,203,557,309,248,107Y09M
67000,67000230,67000230-003,487,1371,711,660,107Y09M
67000,67000230,67000230-001,553,1402,694,708,107Y09M
67000,67000230,67000230-002,1587,4200,2099,2101,107Y09M
67000,67000230,67000230-004,564,1644,836,808,107Y09M
67000,67000230,67000230-005,216,564,305,259,107Y09M
67000,67000230,67000230-008,600,1670,912,758,107Y09M
67000,67000230,67000230-009,263,686,364,322,107Y09M
67000,67000230,67000230-010,379,1095,567,528,107Y09M
67000,67000030,67000030-014,583,1656,872,784,107Y09M
67000,67000030,67000030-008,267,653,368,285,107Y09M
67000,67000030,67000030-022,318,762,436,326,107Y09M
67000,67000030,67000030-010,237,566,321,245,107Y09M
67000,67000030,67000030-011,645,1413,736,677,107Y09M
67000,67000030,67000030-003,627,1609,818,791,107Y09M
67000,67000030,67000030-002,1280,3444,1722,1722,107Y09M
67000,67000030,67000030-001,749,1920,975,945,107Y09M
67000,67000030,67000030-018,375,994,521,473,107Y09M
67000,67000030,67000030-004,692,1885,983,902,107Y09M
67000,67000030,67000030-021,307,815,428,387,107Y09M
67000,67000030,67000030-005,364,1034,525,509,107Y09M
67000,67000030,67000030-020,539,1540,794,746,107Y09M
67000,67000030,67000030-006,559,1474,761,713,107Y09M
67000,67000030,67000030-007,205,492,258,234,107Y09M
67000,67000030,67000030-009,180,418,214,204,107Y09M
67000,67000030,67000030-027,612,1552,835,717,107Y09M
67000,67000030,67000030-019,328,837,459,378,107Y09M
67000,67000030,67000030-025,842,2287,1217,1070,107Y09M
67000,67000030,67000030-026,608,1682,902,780,107Y09M
67000,67000030,67000030-012,483,1142,582,560,107Y09M
67000,67000360,67000360-016,1432,3913,1978,1935,107Y09M
67000,67000360,67000360-009,2220,6036,2827,3209,107Y09M
67000,67000360,67000360-017,1101,3227,1621,1606,107Y09M
67000,67000360,67000360-015,1479,3958,1944,2014,107Y09M
67000,67000360,67000360-008,3565,8479,3942,4537,107Y09M
67000,67000360,67000360-011,3850,9384,4201,5183,107Y09M
67000,67000360,67000360-006,2012,4993,2376,2617,107Y09M
67000,67000360,67000360-002,880,2317,1145,1172,107Y09M
67000,67000360,67000360-005,2399,6268,2933,3335,107Y09M
67000,67000360,67000360-010,3443,8424,3965,4459,107Y09M
67000,67000360,67000360-007,2101,5626,2724,2902,107Y09M
67000,67000360,67000360-004,211,464,256,208,107Y09M
67000,67000360,67000360-012,1259,3580,1748,1832,107Y09M
67000,67000210,67000210-012,256,811,420,391,107Y09M
67000,67000210,67000210-007,752,2124,1069,1055,107Y09M
67000,67000210,67000210-017,587,1838,935,903,107Y09M
67000,67000210,67000210-004,881,2537,1337,1200,107Y09M
67000,67000210,67000210-003,577,1671,885,786,107Y09M
67000,67000210,67000210-014,908,2908,1521,1387,107Y09M
67000,67000210,67000210-008,1163,3436,1733,1703,107Y09M
67000,67000210,67000210-006,576,1811,938,873,107Y09M
67000,67000210,67000210-009,1029,3082,1576,1506,107Y09M
67000,67000210,67000210-013,997,2809,1442,1367,107Y09M
67000,67000210,67000210-018,833,2685,1392,1293,107Y09M
67000,67000210,67000210-001,825,2436,1268,1168,107Y09M
67000,67000210,67000210-002,816,2397,1195,1202,107Y09M
67000,67000350,67000350-003,1610,5496,2733,2763,107Y09M
67000,67000350,67000350-051,1419,4249,2162,2087,107Y09M
67000,67000350,67000350-024,346,1132,584,548,107Y09M
67000,67000350,67000350-014,418,1371,720,651,107Y09M
67000,67000350,67000350-036,625,2205,1113,1092,107Y09M
67000,67000350,67000350-048,586,1777,923,854,107Y09M
67000,67000350,67000350-007,1488,4244,2139,2105,107Y09M
67000,67000350,67000350-037,861,2477,1233,1244,107Y09M
67000,67000350,67000350-006,1113,3241,1646,1595,107Y09M
67000,67000350,67000350-050,2235,6842,3444,3398,107Y09M
67000,67000350,67000350-002,1864,5708,2854,2854,107Y09M
67000,67000350,67000350-009,2425,7199,3608,3591,107Y09M
67000,67000350,67000350-005,1697,5623,2775,2848,107Y09M
67000,67000350,67000350-004,1836,5904,3003,2901,107Y09M
67000,67000350,67000350-023,741,2341,1198,1143,107Y09M
67000,67000350,67000350-022,1348,3989,2058,1931,107Y09M
67000,67000350,67000350-042,1420,4273,2180,2093,107Y09M
67000,67000350,67000350-001,1356,3355,1665,1690,107Y09M
67000,67000350,67000350-013,1773,5565,2859,2706,107Y09M
67000,67000350,67000350-032,499,1744,893,851,107Y09M
67000,67000350,67000350-025,705,2075,1096,979,107Y09M
67000,67000350,67000350-029,386,1277,601,676,107Y09M
67000,67000350,67000350-028,556,1744,866,878,107Y09M
67000,67000350,67000350-031,512,1649,820,829,107Y09M
67000,67000350,67000350-027,580,1833,936,897,107Y09M
67000,67000350,67000350-030,1126,3591,1808,1783,107Y09M
67000,67000350,67000350-033,420,1543,796,747,107Y09M
67000,67000350,67000350-011,868,2596,1315,1281,107Y09M
67000,67000350,67000350-016,1087,3253,1659,1594,107Y09M
67000,67000350,67000350-041,1624,5078,2577,2501,107Y09M
67000,67000350,67000350-015,2228,6640,3336,3304,107Y09M
67000,67000350,67000350-017,761,2264,1167,1097,107Y09M
67000,67000350,67000350-049,893,2726,1333,1393,107Y09M
67000,67000350,67000350-044,1744,4789,2411,2378,107Y09M
67000,67000350,67000350-047,1313,4037,2061,1976,107Y09M
67000,67000350,67000350-021,1264,3897,1930,1967,107Y09M
67000,67000350,67000350-020,1798,5651,2870,2781,107Y09M
67000,67000350,67000350-045,1755,5447,2707,2740,107Y09M
67000,67000350,67000350-008,1952,5647,2891,2756,107Y09M
67000,67000350,67000350-035,348,1056,534,522,107Y09M
67000,67000350,67000350-010,2334,7374,3686,3688,107Y09M
67000,67000350,67000350-018,3333,9200,4790,4410,107Y09M
67000,67000350,67000350-038,1169,3317,1598,1719,107Y09M
67000,67000350,67000350-046,1625,4806,2332,2474,107Y09M
67000,67000350,67000350-039,1810,5555,2751,2804,107Y09M
67000,67000350,67000350-040,1246,3880,1942,1938,107Y09M
67000,67000350,67000350-043,1991,5285,2560,2725,107Y09M
67000,67000350,67000350-026,806,2518,1329,1189,107Y09M
67000,67000350,67000350-012,681,2115,1122,993,107Y09M
67000,67000350,67000350-034,508,1684,834,850,107Y09M
67000,67000350,67000350-019,658,1840,926,914,107Y09M
67000,67000140,67000140-004,610,1852,961,891,107Y09M
67000,67000140,67000140-010,515,1527,795,732,107Y09M
67000,67000140,67000140-009,530,1550,795,755,107Y09M
67000,67000140,67000140-001,1206,3632,1810,1822,107Y09M
67000,67000140,67000140-007,264,850,447,403,107Y09M
67000,67000140,67000140-002,875,2738,1386,1352,107Y09M
67000,67000140,67000140-005,540,1682,859,823,107Y09M
67000,67000140,67000140-003,598,1836,957,879,107Y09M
67000,67000140,67000140-011,305,923,464,459,107Y09M
67000,67000140,67000140-008,531,1464,754,710,107Y09M
67000,67000140,67000140-012,1714,4999,2397,2602,107Y09M
67000,67000140,67000140-006,580,1682,847,835,107Y09M
67000,67000120,67000120-025,742,2063,1056,1007,107Y09M
67000,67000120,67000120-020,1009,2694,1407,1287,107Y09M
67000,67000120,67000120-006,1811,4815,2347,2468,107Y09M
67000,67000120,67000120-023,2153,6375,3019,3356,107Y09M
67000,67000120,67000120-019,626,1789,914,875,107Y09M
67000,67000120,67000120-005,2355,7099,3487,3612,107Y09M
67000,67000120,67000120-007,844,2414,1235,1179,107Y09M
67000,67000120,67000120-024,868,2372,1228,1144,107Y09M
67000,67000120,67000120-002,1163,3358,1654,1704,107Y09M
67000,67000120,67000120-001,991,2546,1229,1317,107Y09M
67000,67000120,67000120-027,1867,5386,2621,2765,107Y09M
67000,67000120,67000120-004,1807,4881,2342,2539,107Y09M
67000,67000120,67000120-012,881,2514,1276,1238,107Y09M
67000,67000120,67000120-026,1129,3098,1634,1464,107Y09M
67000,67000120,67000120-022,433,1177,615,562,107Y09M
67000,67000120,67000120-003,2136,6547,3257,3290,107Y09M
67000,67000100,67000100-002,1255,3515,1775,1740,107Y09M
67000,67000100,67000100-005,179,433,238,195,107Y09M
67000,67000100,67000100-001,865,2320,1184,1136,107Y09M
67000,67000100,67000100-016,737,2155,1144,1011,107Y09M
67000,67000100,67000100-013,364,990,531,459,107Y09M
67000,67000100,67000100-008,506,1417,727,690,107Y09M
67000,67000100,67000100-014,523,1364,731,633,107Y09M
67000,67000100,67000100-015,1097,2886,1499,1387,107Y09M
67000,67000100,67000100-007,1533,3993,1949,2044,107Y09M
67000,67000100,67000100-006,890,2282,1096,1186,107Y09M
67000,67000060,67000060-004,446,1057,542,515,107Y09M
67000,67000060,67000060-005,496,1234,652,582,107Y09M
67000,67000060,67000060-009,217,424,249,175,107Y09M
67000,67000060,67000060-001,639,1601,824,777,107Y09M
67000,67000060,67000060-002,1115,2895,1450,1445,107Y09M
67000,67000060,67000060-003,695,1661,867,794,107Y09M
67000,67000060,67000060-007,404,975,529,446,107Y09M
67000,67000060,67000060-011,905,2414,1310,1104,107Y09M
67000,67000060,67000060-010,177,407,234,173,107Y09M
67000,67000060,67000060-014,484,1208,665,543,107Y09M
67000,67000060,67000060-013,482,1263,678,585,107Y09M
67000,67000060,67000060-008,185,469,272,197,107Y09M
67000,67000060,67000060-006,606,1385,742,643,107Y09M
67000,67000060,67000060-015,388,1031,570,461,107Y09M
67000,67000060,67000060-016,827,2105,1095,1010,107Y09M
67000,67000060,67000060-012,275,754,407,347,107Y09M
67000,67000320,67000320-038,1442,3260,1635,1625,107Y09M
67000,67000320,67000320-003,2841,7807,3857,3950,107Y09M
67000,67000320,67000320-028,786,1913,950,963,107Y09M
67000,67000320,67000320-016,747,1697,813,884,107Y09M
67000,67000320,67000320-023,590,1357,653,704,107Y09M
67000,67000320,67000320-022,2014,5154,2492,2662,107Y09M
67000,67000320,67000320-010,1506,3689,1764,1925,107Y09M
67000,67000320,67000320-006,2128,5179,2519,2660,107Y09M
67000,67000320,67000320-045,1869,5696,2782,2914,107Y09M
67000,67000320,67000320-037,1062,2277,1140,1137,107Y09M
67000,67000320,67000320-013,2572,6378,2962,3416,107Y09M
67000,67000320,67000320-014,2395,5762,2735,3027,107Y09M
67000,67000320,67000320-029,1955,4747,2289,2458,107Y09M
67000,67000320,67000320-008,2277,6026,2871,3155,107Y09M
67000,67000320,67000320-011,693,1639,830,809,107Y09M
67000,67000320,67000320-031,1470,3547,1699,1848,107Y09M
67000,67000320,67000320-036,926,2132,1019,1113,107Y09M
67000,67000320,67000320-033,1030,2690,1320,1370,107Y09M
67000,67000320,67000320-034,1115,2706,1265,1441,107Y09M
67000,67000320,67000320-025,2162,6076,2925,3151,107Y09M
67000,67000320,67000320-044,1097,3298,1634,1664,107Y09M
67000,67000320,67000320-007,1313,3485,1667,1818,107Y09M
67000,67000320,67000320-005,2317,5439,2628,2811,107Y09M
67000,67000320,67000320-041,2730,7707,3612,4095,107Y09M
67000,67000320,67000320-035,1346,3838,1779,2059,107Y09M
67000,67000320,67000320-012,1981,5088,2372,2716,107Y09M
67000,67000320,67000320-040,2323,5238,2593,2645,107Y09M
67000,67000320,67000320-019,2294,5984,2728,3256,107Y09M
67000,67000320,67000320-030,1254,2837,1315,1522,107Y09M
67000,67000320,67000320-032,1958,5580,2653,2927,107Y09M
67000,67000320,67000320-004,1274,3379,1612,1767,107Y09M
67000,67000320,67000320-027,1710,4411,2129,2282,107Y09M
67000,67000320,67000320-021,968,2350,1119,1231,107Y09M
67000,67000320,67000320-020,2038,5312,2561,2751,107Y09M
67000,67000320,67000320-001,996,2514,1167,1347,107Y09M
67000,67000320,67000320-042,1397,4064,1932,2132,107Y09M
67000,67000320,67000320-009,1126,2746,1297,1449,107Y09M
67000,67000320,67000320-043,2045,6286,3069,3217,107Y09M
67000,67000320,67000320-002,1342,3468,1650,1818,107Y09M
67000,67000320,67000320-015,836,1818,814,1004,107Y09M
67000,67000320,67000320-039,1859,4842,2245,2597,107Y09M
67000,67000320,67000320-026,1276,3495,1764,1731,107Y09M
67000,67000320,67000320-018,783,1759,847,912,107Y09M
67000,67000320,67000320-024,2433,5726,2606,3120,107Y09M
67000,67000320,67000320-017,1890,5718,2822,2896,107Y09M
67000,67000250,67000250-002,284,894,502,392,107Y09M
67000,67000250,67000250-003,158,463,258,205,107Y09M
67000,67000250,67000250-004,215,611,339,272,107Y09M
67000,67000250,67000250-007,429,1333,713,620,107Y09M
67000,67000250,67000250-008,374,1190,615,575,107Y09M
67000,67000250,67000250-006,283,853,478,375,107Y09M
67000,67000250,67000250-005,244,731,406,325,107Y09M
67000,67000250,67000250-001,564,1540,819,721,107Y09M
67000,67000250,67000250-009,307,1132,583,549,107Y09M
67000,67000330,67000330-004,776,1606,747,859,107Y09M
67000,67000330,67000330-022,1958,5077,2514,2563,107Y09M
67000,67000330,67000330-021,1089,2579,1234,1345,107Y09M
67000,67000330,67000330-023,1487,3837,1884,1953,107Y09M
67000,67000330,67000330-035,2065,5832,2754,3078,107Y09M
67000,67000330,67000330-027,1328,3739,1812,1927,107Y09M
67000,67000330,67000330-038,646,2040,1080,960,107Y09M
67000,67000330,67000330-008,1417,3627,1738,1889,107Y09M
67000,67000330,67000330-011,1799,4800,2327,2473,107Y09M
67000,67000330,67000330-025,1006,2667,1276,1391,107Y09M
67000,67000330,67000330-019,786,2585,1330,1255,107Y09M
67000,67000330,67000330-001,794,1821,855,966,107Y09M
67000,67000330,67000330-020,930,3104,1598,1506,107Y09M
67000,67000330,67000330-034,1928,5588,2717,2871,107Y09M
67000,67000330,67000330-013,1430,4186,2046,2140,107Y09M
67000,67000330,67000330-003,522,998,493,505,107Y09M
67000,67000330,67000330-026,1339,3884,1880,2004,107Y09M
67000,67000330,67000330-037,638,2102,1135,967,107Y09M
67000,67000330,67000330-028,2196,5726,2772,2954,107Y09M
67000,67000330,67000330-029,1399,3122,1668,1454,107Y09M
67000,67000330,67000330-039,1079,2806,1392,1414,107Y09M
67000,67000330,67000330-032,1914,5891,3012,2879,107Y09M
67000,67000330,67000330-017,1338,4063,2070,1993,107Y09M
67000,67000330,67000330-033,1391,4126,2049,2077,107Y09M
67000,67000330,67000330-009,1278,3411,1624,1787,107Y09M
67000,67000330,67000330-015,845,2522,1295,1227,107Y09M
67000,67000330,67000330-014,816,2453,1278,1175,107Y09M
67000,67000330,67000330-016,500,1410,738,672,107Y09M
67000,67000330,67000330-030,2490,6609,3220,3389,107Y09M
67000,67000330,67000330-024,1922,3782,1762,2020,107Y09M
67000,67000330,67000330-006,1083,2549,1225,1324,107Y09M
67000,67000330,67000330-007,1231,3150,1504,1646,107Y09M
67000,67000330,67000330-031,672,1857,918,939,107Y09M
67000,67000330,67000330-005,972,2554,1257,1297,107Y09M
67000,67000330,67000330-018,722,2456,1276,1180,107Y09M
67000,67000330,67000330-036,705,2027,1035,992,107Y09M
67000,67000330,67000330-040,1538,4259,2215,2044,107Y09M
67000,67000050,67000050-023,854,2560,1329,1231,107Y09M
67000,67000050,67000050-004,510,1491,763,728,107Y09M
67000,67000050,67000050-010,615,1568,810,758,107Y09M
67000,67000050,67000050-013,528,1361,722,639,107Y09M
67000,67000050,67000050-022,852,2251,1183,1068,107Y09M
67000,67000050,67000050-002,519,1535,803,732,107Y09M
67000,67000050,67000050-001,672,1855,944,911,107Y09M
67000,67000050,67000050-012,546,1436,735,701,107Y09M
67000,67000050,67000050-018,642,1607,840,767,107Y09M
67000,67000050,67000050-024,575,1345,679,666,107Y09M
67000,67000050,67000050-011,739,1879,969,910,107Y09M
67000,67000050,67000050-019,478,1108,598,510,107Y09M
67000,67000050,67000050-003,508,1468,779,689,107Y09M
67000,67000050,67000050-014,785,2006,1041,965,107Y09M
67000,67000040,67000040-006,324,831,409,422,107Y09M
67000,67000040,67000040-005,622,1576,833,743,107Y09M
67000,67000040,67000040-001,804,2039,1063,976,107Y09M
67000,67000040,67000040-010,275,724,373,351,107Y09M
67000,67000040,67000040-003,479,1258,662,596,107Y09M
67000,67000040,67000040-007,634,1651,854,797,107Y09M
67000,67000040,67000040-002,659,1767,935,832,107Y09M
67000,67000040,67000040-013,639,1836,998,838,107Y09M
67000,67000040,67000040-004,1168,3102,1535,1567,107Y09M
67000,67000040,67000040-012,475,1350,730,620,107Y09M
67000,67000040,67000040-008,745,2046,1072,974,107Y09M
67000,67000040,67000040-011,562,1594,840,754,107Y09M
67000,67000040,67000040-009,538,1445,763,682,107Y09M
67000,67000160,67000160-016,426,1318,616,702,107Y09M
67000,67000160,67000160-013,369,913,486,427,107Y09M
67000,67000160,67000160-020,970,2658,1358,1300,107Y09M
67000,67000160,67000160-021,1032,2800,1414,1386,107Y09M
67000,67000160,67000160-015,488,1521,773,748,107Y09M
67000,67000160,67000160-001,441,1258,607,651,107Y09M
67000,67000160,67000160-019,543,1359,732,627,107Y09M
67000,67000160,67000160-022,872,2228,1167,1061,107Y09M
67000,67000160,67000160-023,671,1790,953,837,107Y09M
67000,67000160,67000160-014,298,697,376,321,107Y09M
67000,67000160,67000160-018,417,1052,496,556,107Y09M
67000,67000160,67000160-017,751,2103,1066,1037,107Y09M
67000,67000070,67000070-011,1226,3449,1699,1750,107Y09M
67000,67000070,67000070-006,860,2296,1123,1173,107Y09M
67000,67000070,67000070-032,685,2007,1034,973,107Y09M
67000,67000070,67000070-010,474,1255,678,577,107Y09M
67000,67000070,67000070-028,374,1047,534,513,107Y09M
67000,67000070,67000070-024,570,1524,779,745,107Y09M
67000,67000070,67000070-003,1077,3166,1557,1609,107Y09M
67000,67000070,67000070-009,1423,4248,2153,2095,107Y09M
67000,67000070,67000070-014,1016,2683,1331,1352,107Y09M
67000,67000070,67000070-005,932,2500,1245,1255,107Y09M
67000,67000070,67000070-019,911,2354,1246,1108,107Y09M
67000,67000070,67000070-017,945,2676,1384,1292,107Y09M
67000,67000070,67000070-033,549,1592,848,744,107Y09M
67000,67000070,67000070-022,435,1286,678,608,107Y09M
67000,67000070,67000070-021,593,1412,754,658,107Y09M
67000,67000070,67000070-030,819,2234,1115,1119,107Y09M
67000,67000070,67000070-015,674,1886,965,921,107Y09M
67000,67000070,67000070-007,589,1836,926,910,107Y09M
67000,67000070,67000070-031,655,1913,1013,900,107Y09M
67000,67000070,67000070-004,1028,2973,1476,1497,107Y09M
67000,67000190,67000190-021,1947,5243,2620,2623,107Y09M
67000,67000190,67000190-011,517,1469,741,728,107Y09M
67000,67000190,67000190-013,312,799,425,374,107Y09M
67000,67000190,67000190-014,418,1211,626,585,107Y09M
67000,67000190,67000190-008,715,1950,976,974,107Y09M
67000,67000190,67000190-004,1233,3356,1675,1681,107Y09M
67000,67000190,67000190-018,642,1777,894,883,107Y09M
67000,67000190,67000190-015,686,1950,999,951,107Y09M
67000,67000190,67000190-003,2452,6649,3201,3448,107Y09M
67000,67000190,67000190-002,1848,5189,2489,2700,107Y09M
67000,67000190,67000190-023,805,2256,1156,1100,107Y09M
67000,67000190,67000190-001,593,1450,735,715,107Y09M
67000,67000190,67000190-005,744,2250,1099,1151,107Y09M
67000,67000190,67000190-010,725,2020,1064,956,107Y09M
67000,67000190,67000190-009,474,1409,738,671,107Y09M
67000,67000190,67000190-022,528,1348,714,634,107Y09M
67000,67000190,67000190-012,769,2182,1085,1097,107Y09M
67000,67000190,67000190-019,633,1779,936,843,107Y09M
67000,67000190,67000190-020,442,1263,670,593,107Y09M
67000,67000190,67000190-024,1500,3307,1719,1588,107Y09M
67000,67000180,67000180-018,791,2496,1271,1225,107Y09M
67000,67000180,67000180-017,203,492,263,229,107Y09M
67000,67000180,67000180-016,536,1673,865,808,107Y09M
67000,67000180,67000180-004,1735,5196,2584,2612,107Y09M
67000,67000180,67000180-011,578,1683,849,834,107Y09M
67000,67000180,67000180-013,1020,3265,1650,1615,107Y09M
67000,67000180,67000180-019,324,1047,561,486,107Y09M
67000,67000180,67000180-009,1242,3891,1936,1955,107Y09M
67000,67000180,67000180-002,1665,4566,2304,2262,107Y09M
67000,67000180,67000180-001,1300,3637,1812,1825,107Y09M
67000,67000180,67000180-015,861,2487,1310,1177,107Y09M
67000,67000180,67000180-014,712,2341,1253,1088,107Y09M
67000,67000180,67000180-010,765,2579,1287,1292,107Y09M
67000,67000180,67000180-020,399,1111,621,490,107Y09M
67000,67000180,67000180-012,1250,3897,1964,1933,107Y09M
67000,67000180,67000180-003,1098,3178,1626,1552,107Y09M
67000,67000200,67000200-006,639,2132,1058,1074,107Y09M
67000,67000200,67000200-008,1654,5237,2700,2537,107Y09M
67000,67000200,67000200-004,275,807,422,385,107Y09M
67000,67000200,67000200-007,1315,3961,2002,1959,107Y09M
67000,67000200,67000200-011,1248,3528,1731,1797,107Y09M
67000,67000200,67000200-003,1033,3064,1530,1534,107Y09M
67000,67000200,67000200-010,1349,4076,1996,2080,107Y09M
67000,67000200,67000200-001,1255,3498,1681,1817,107Y09M
67000,67000200,67000200-002,2719,7369,3677,3692,107Y09M
67000,67000200,67000200-009,695,2053,1074,979,107Y09M
67000,67000200,67000200-005,358,1096,554,542,107Y09M
67000,67000010,67000010-003,1268,3328,1603,1725,107Y09M
67000,67000010,67000010-010,566,1665,864,801,107Y09M
67000,67000010,67000010-007,1379,3671,1806,1865,107Y09M
67000,67000010,67000010-009,509,1400,707,693,107Y09M
67000,67000010,67000010-025,751,1863,973,890,107Y09M
67000,67000010,67000010-019,732,2013,1045,968,107Y09M
67000,67000010,67000010-018,807,1954,1057,897,107Y09M
67000,67000010,67000010-008,1769,5268,2609,2659,107Y09M
67000,67000010,67000010-014,1419,3805,1884,1921,107Y09M
67000,67000010,67000010-015,2082,5206,2515,2691,107Y09M
67000,67000010,67000010-002,1157,2841,1392,1449,107Y09M
67000,67000010,67000010-030,1317,3153,1635,1518,107Y09M
67000,67000010,67000010-026,450,1063,567,496,107Y09M
67000,67000010,67000010-001,2157,5471,2650,2821,107Y09M
67000,67000010,67000010-020,1548,4330,2090,2240,107Y09M
67000,67000010,67000010-012,1181,2824,1398,1426,107Y09M
67000,67000010,67000010-016,682,1991,1016,975,107Y09M
67000,67000010,67000010-027,2068,5656,2770,2886,107Y09M
67000,67000010,67000010-029,2752,8254,4028,4226,107Y09M
67000,67000010,67000010-028,2204,6093,2956,3137,107Y09M
67000,67000010,67000010-021,770,2182,1100,1082,107Y09M
67000,67000010,67000010-013,918,2056,957,1099,107Y09M
67000,67000010,67000010-017,593,1579,808,771,107Y09M
67000,67000240,67000240-007,940,2570,1304,1266,107Y09M
67000,67000240,67000240-003,295,767,424,343,107Y09M
67000,67000240,67000240-005,378,1047,550,497,107Y09M
67000,67000240,67000240-001,760,2058,1066,992,107Y09M
67000,67000240,67000240-004,419,1117,625,492,107Y09M
67000,67000240,67000240-006,254,719,390,329,107Y09M
67000,67000240,67000240-002,477,1317,712,605,107Y09M
67000,67000130,67000130-012,606,1528,819,709,107Y09M
67000,67000130,67000130-011,410,1098,575,523,107Y09M
67000,67000130,67000130-013,621,1602,814,788,107Y09M
67000,67000130,67000130-001,1651,4410,2148,2262,107Y09M
67000,67000130,67000130-009,479,1181,628,553,107Y09M
67000,67000130,67000130-003,536,1399,748,651,107Y09M
67000,67000130,67000130-004,359,922,499,423,107Y09M
67000,67000130,67000130-006,963,2766,1411,1355,107Y09M
67000,67000130,67000130-007,840,2262,1178,1084,107Y09M
67000,67000130,67000130-005,802,2185,1100,1085,107Y09M
67000,67000130,67000130-010,906,2396,1218,1178,107Y09M
67000,67000130,67000130-002,941,2624,1306,1318,107Y09M
67000,67000130,67000130-008,520,1370,728,642,107Y09M
67000,67000300,67000300-002,260,677,366,311,107Y09M
67000,67000300,67000300-006,130,326,179,147,107Y09M
67000,67000300,67000300-003,75,149,83,66,107Y09M
67000,67000300,67000300-005,138,360,197,163,107Y09M
67000,67000300,67000300-008,165,480,262,218,107Y09M
67000,67000300,67000300-001,438,1152,595,557,107Y09M
67000,67000300,67000300-004,143,405,220,185,107Y09M
67000,67000300,67000300-007,184,451,248,203,107Y09M
67000,67000280,67000280-014,1297,3779,1937,1842,107Y09M
67000,67000280,67000280-013,1016,3041,1484,1557,107Y09M
67000,67000280,67000280-017,1155,3364,1689,1675,107Y09M
67000,67000280,67000280-011,686,2150,1107,1043,107Y09M
67000,67000280,67000280-002,1564,4322,2250,2072,107Y09M
67000,67000280,67000280-021,1163,3686,1808,1878,107Y09M
67000,67000280,67000280-016,639,1985,1042,943,107Y09M
67000,67000280,67000280-010,253,810,427,383,107Y09M
67000,67000280,67000280-012,971,2199,1315,884,107Y09M
67000,67000280,67000280-001,2292,7168,3580,3588,107Y09M
67000,67000280,67000280-018,1595,5130,2575,2555,107Y09M
67000,67000280,67000280-004,1304,3881,1956,1925,107Y09M
67000,67000280,67000280-007,862,2668,1312,1356,107Y09M
67000,67000280,67000280-008,676,2121,1086,1035,107Y09M
67000,67000280,67000280-009,1146,3698,1841,1857,107Y09M
67000,67000280,67000280-006,1312,3920,1975,1945,107Y09M
67000,67000280,67000280-005,1328,3881,1916,1965,107Y09M
67000,67000280,67000280-015,814,2292,1206,1086,107Y09M
67000,67000280,67000280-019,991,2969,1505,1464,107Y09M
67000,67000280,67000280-003,949,2727,1340,1387,107Y09M
67000,67000280,67000280-020,874,2613,1321,1292,107Y09M
67000,67000290,67000290-017,190,545,292,253,107Y09M
67000,67000290,67000290-002,750,2352,1214,1138,107Y09M
67000,67000290,67000290-007,1145,3644,1869,1775,107Y09M
67000,67000290,67000290-004,898,2823,1475,1348,107Y09M
67000,67000290,67000290-013,438,1387,738,649,107Y09M
67000,67000290,67000290-008,1147,3656,1870,1786,107Y09M
67000,67000290,67000290-009,681,2141,1050,1091,107Y09M
67000,67000290,67000290-018,1302,4040,2047,1993,107Y09M
67000,67000290,67000290-019,568,1714,909,805,107Y09M
67000,67000290,67000290-003,1281,3732,1892,1840,107Y09M
67000,67000290,67000290-016,763,2113,1089,1024,107Y09M
67000,67000290,67000290-012,574,1755,909,846,107Y09M
67000,67000290,67000290-006,297,805,441,364,107Y09M
67000,67000290,67000290-005,386,1195,630,565,107Y09M
67000,67000290,67000290-001,816,2489,1309,1180,107Y09M
67000,67000020,67000020-033,625,1578,858,720,107Y09M
67000,67000020,67000020-032,433,1001,559,442,107Y09M
67000,67000020,67000020-028,714,1770,930,840,107Y09M
67000,67000020,67000020-030,503,1158,640,518,107Y09M
67000,67000020,67000020-027,726,1814,939,875,107Y09M
67000,67000020,67000020-001,663,1796,929,867,107Y09M
67000,67000020,67000020-031,494,1242,655,587,107Y09M
67000,67000020,67000020-010,435,1025,580,445,107Y09M
67000,67000020,67000020-011,1591,4325,2197,2128,107Y09M
67000,67000020,67000020-026,735,1684,862,822,107Y09M
67000,67000020,67000020-029,705,1804,957,847,107Y09M
67000,67000020,67000020-008,1652,4336,2170,2166,107Y09M
67000,67000020,67000020-014,753,1894,993,901,107Y09M
10016,10016060,10016060-003,293,730,380,350,107Y09M
10016,10016060,10016060-004,164,418,232,186,107Y09M
10016,10016060,10016060-002,247,666,350,316,107Y09M
10016,10016060,10016060-001,128,271,133,138,107Y09M
10016,10016060,10016060-006,420,1393,705,688,107Y09M
10016,10016060,10016060-005,134,389,199,190,107Y09M
10016,10016030,10016030-015,85,285,140,145,107Y09M
10016,10016030,10016030-007,69,187,90,97,107Y09M
10016,10016030,10016030-001,208,624,322,302,107Y09M
10016,10016030,10016030-009,133,308,166,142,107Y09M
10016,10016030,10016030-012,530,1625,883,742,107Y09M
10016,10016030,10016030-006,97,247,125,122,107Y09M
10016,10016030,10016030-008,681,1981,1009,972,107Y09M
10016,10016030,10016030-003,31,121,59,62,107Y09M
10016,10016030,10016030-010,343,801,426,375,107Y09M
10016,10016030,10016030-014,91,279,161,118,107Y09M
10016,10016030,10016030-011,302,877,457,420,107Y09M
10016,10016030,10016030-013,424,1264,659,605,107Y09M
10016,10016030,10016030-005,138,322,164,158,107Y09M
10016,10016030,10016030-002,248,747,396,351,107Y09M
10016,10016030,10016030-004,62,171,88,83,107Y09M
10016,10016040,10016040-006,62,158,81,77,107Y09M
10016,10016040,10016040-005,262,753,379,374,107Y09M
10016,10016040,10016040-003,92,326,179,147,107Y09M
10016,10016040,10016040-010,514,1449,743,706,107Y09M
10016,10016040,10016040-011,834,2394,1229,1165,107Y09M
10016,10016040,10016040-002,162,474,247,227,107Y09M
10016,10016040,10016040-008,105,231,122,109,107Y09M
10016,10016040,10016040-007,288,706,336,370,107Y09M
10016,10016040,10016040-004,351,916,480,436,107Y09M
10016,10016040,10016040-009,259,654,351,303,107Y09M
10016,10016040,10016040-001,113,344,184,160,107Y09M
10016,10016010,10016010-031,447,1356,693,663,107Y09M
10016,10016010,10016010-027,681,1957,1019,938,107Y09M
10016,10016010,10016010-004,254,593,302,291,107Y09M
10016,10016010,10016010-007,431,897,454,443,107Y09M
10016,10016010,10016010-030,140,436,220,216,107Y09M
10016,10016010,10016010-029,224,398,254,144,107Y09M
10016,10016010,10016010-020,1121,3073,1538,1535,107Y09M
10016,10016010,10016010-010,590,1380,683,697,107Y09M
10016,10016010,10016010-008,902,2259,1076,1183,107Y09M
10016,10016010,10016010-018,436,943,544,399,107Y09M
10016,10016010,10016010-009,1893,4735,2268,2467,107Y09M
10016,10016010,10016010-023,257,698,363,335,107Y09M
10016,10016010,10016010-015,1451,3869,1949,1920,107Y09M
10016,10016010,10016010-014,3615,6940,3539,3401,107Y09M
10016,10016010,10016010-016,1379,4023,1973,2050,107Y09M
10016,10016010,10016010-022,884,2416,1260,1156,107Y09M
10016,10016010,10016010-033,333,851,487,364,107Y09M
10016,10016010,10016010-003,260,635,306,329,107Y09M
10016,10016010,10016010-019,401,1085,575,510,107Y09M
10016,10016010,10016010-013,619,1713,873,840,107Y09M
10016,10016010,10016010-006,451,1145,581,564,107Y09M
10016,10016010,10016010-032,505,1631,848,783,107Y09M
10016,10016010,10016010-017,984,2053,1187,866,107Y09M
10016,10016010,10016010-024,410,1144,604,540,107Y09M
10016,10016010,10016010-005,405,1037,524,513,107Y09M
10016,10016010,10016010-034,125,375,203,172,107Y09M
10016,10016010,10016010-002,316,511,318,193,107Y09M
10016,10016010,10016010-011,2288,6228,3034,3194,107Y09M
10016,10016010,10016010-021,159,467,240,227,107Y09M
10016,10016010,10016010-012,1129,2925,1444,1481,107Y09M
10016,10016010,10016010-025,498,1231,629,602,107Y09M
10016,10016010,10016010-028,1028,2840,1470,1370,107Y09M
10016,10016010,10016010-026,261,683,339,344,107Y09M
10016,10016050,10016050-003,139,317,191,126,107Y09M
10016,10016050,10016050-004,183,502,270,232,107Y09M
10016,10016050,10016050-002,212,508,265,243,107Y09M
10016,10016050,10016050-007,100,252,152,100,107Y09M
10016,10016050,10016050-008,155,271,146,125,107Y09M
10016,10016050,10016050-001,317,798,468,330,107Y09M
10016,10016050,10016050-006,186,620,323,297,107Y09M
10016,10016050,10016050-009,138,363,193,170,107Y09M
10016,10016050,10016050-005,601,1606,823,783,107Y09M
10016,10016020,10016020-011,86,242,119,123,107Y09M
10016,10016020,10016020-017,32,104,49,55,107Y09M
10016,10016020,10016020-006,132,368,193,175,107Y09M
10016,10016020,10016020-004,119,331,178,153,107Y09M
10016,10016020,10016020-020,289,750,399,351,107Y09M
10016,10016020,10016020-009,371,830,433,397,107Y09M
10016,10016020,10016020-008,335,743,446,297,107Y09M
10016,10016020,10016020-015,356,894,435,459,107Y09M
10016,10016020,10016020-010,51,142,66,76,107Y09M
10016,10016020,10016020-019,400,1161,615,546,107Y09M
10016,10016020,10016020-003,106,271,144,127,107Y09M
10016,10016020,10016020-005,281,762,392,370,107Y09M
10016,10016020,10016020-016,131,290,171,119,107Y09M
10016,10016020,10016020-007,314,825,422,403,107Y09M
10016,10016020,10016020-014,141,337,172,165,107Y09M
10016,10016020,10016020-001,468,1282,651,631,107Y09M
10016,10016020,10016020-002,146,376,199,177,107Y09M
10016,10016020,10016020-018,405,935,465,470,107Y09M
10016,10016020,10016020-013,426,705,488,217,107Y09M
10016,10016020,10016020-012,101,332,167,165,107Y09M
10016,10016020,10016020-021,680,2025,1019,1006,107Y09M
10016,10016020,10016020-022,296,812,440,372,107Y09M
